,pubYear,firstAuthor,uniqueFirstAuthors,numberNewFirstAuthors,cumulativeFirstAuthors,fullAuthor,cleanFullAuthors,uniqueAuthors,numberNewAuthors,cumulativeAuthors
0,2012,"Patrick B Ryan, Christian Reich, Ryan M Carnahan, J Marc Overhage","['Christian Reich', 'Patrick B Ryan', 'Ryan M Carnahan']",3,3,"['Patrick B, Ryan', 'David, Madigan', 'Paul E, Stang', 'J Marc, Overhage', 'Judith A, Racoosin', 'Abraham G, Hartzema'], ['Christian, Reich', 'Patrick B, Ryan', 'Paul E, Stang', 'Mitra, Rocca'], ['Ryan M, Carnahan', 'Kevin G, Moores'], ['J Marc, Overhage', 'Patrick B, Ryan', 'Christian G, Reich', 'Abraham G, Hartzema', 'Paul E, Stang']","'Patrick B Ryan', 'David Madigan', 'Paul E Stang', 'J Marc Overhage', 'Judith A Racoosin', 'Abraham G Hartzema', 'Christian Reich', 'Patrick B Ryan', 'Paul E Stang', 'Mitra Rocca', 'Ryan M Carnahan', 'Kevin G Moores', 'J Marc Overhage', 'Patrick B Ryan', 'Christian G Reich', 'Abraham G Hartzema', 'Paul E Stang'","['Abraham G Hartzema', 'Christian Reich', 'David Madigan', 'J Marc Overhage', 'Judith A Racoosin', 'Kevin G Moores', 'Mitra Rocca', 'Patrick B Ryan', 'Paul E Stang', 'Ryan M Carnahan']",10,10
1,2013,"Vojtech Huser, Lian Lian Duan, Martijn J Schuemie, Omolola I Ogunyemi, R Harpaz, Xiaochun Li, Frank J Defalco, Xiaofeng Zhou, Abraham G Hartzema, Christian G Reich, Paul E Stang, David Madigan","['Abraham G Hartzema', 'Christian Reich', 'Frank J Defalco', 'Lian Lian Duan', 'Martijn J Schuemie', 'Omolola I Ogunyemi', 'Patrick B Ryan', 'Paul E Stang', 'R Harpaz', 'Ryan M Carnahan', 'Vojtech Huser', 'Xiaochun Li', 'Xiaofeng Zhou']",10,13,"['Vojtech, Huser', 'James J, Cimino'], ['Lian, Lian Duan', 'Mohammad, Khoshneshin', 'W Nick, Street', 'Mei, Liu'], ['Martijn J, Schuemie', 'Rosa, Gini', 'Preciosa M, Coloma', 'Huub, Straatman', 'Ron M C, Herings', 'Lars, Pedersen', 'Francesco, Innocenti', 'Giampiero, Mazzaglia', 'Gino, Picelli', 'Johan, van der Lei', 'Miriam C J M, Sturkenboom'], ['Omolola I, Ogunyemi', 'Daniella, Meeker', 'Hyeon-Eui, Kim', 'Naveen, Ashish', 'Seena, Farzaneh', 'Aziz, Boxwala'], ['R, Harpaz', 'W, DuMouchel', 'P, LePendu', 'A, Bauer-Mehren', 'P, Ryan', 'N H, Shah'], ['Xiaochun, Li', 'Siu, Hui', 'Patrick, Ryan', 'Marc, Rosenman', 'Marc, Overhage'], ['Frank J, Defalco', 'Patrick B, Ryan', 'M, Soledad Cepeda'], ['Xiaofeng, Zhou', 'Sundaresan, Murugesan', 'Harshvinder, Bhullar', 'Qing, Liu', 'Bing, Cai', 'Chuck, Wentworth', 'Andrew, Bate'], ['Abraham G, Hartzema', 'Christian G, Reich', 'Patrick B, Ryan', 'Paul E, Stang', 'David, Madigan', 'Emily, Welebob', 'J Marc, Overhage'], ['Christian G, Reich', 'Patrick B, Ryan', 'Marc A, Suchard'], ['Paul E, Stang', 'Patrick B, Ryan', 'J Marc, Overhage', 'Martijn J, Schuemie', 'Abraham G, Hartzema', 'Emily, Welebob'], ['David, Madigan', 'Patrick B, Ryan', 'Martijn, Schuemie']","'Vojtech Huser', 'James J Cimino', 'Lian Lian Duan', 'Mohammad Khoshneshin', 'W Nick Street', 'Mei Liu', 'Martijn J Schuemie', 'Rosa Gini', 'Preciosa M Coloma', 'Huub Straatman', 'Ron M C Herings', 'Lars Pedersen', 'Francesco Innocenti', 'Giampiero Mazzaglia', 'Gino Picelli', 'Johan van der Lei', 'Miriam C J M Sturkenboom', 'Omolola I Ogunyemi', 'Daniella Meeker', 'Hyeon-Eui Kim', 'Naveen Ashish', 'Seena Farzaneh', 'Aziz Boxwala', 'R Harpaz', 'W DuMouchel', 'P LePendu', 'A Bauer-Mehren', 'P Ryan', 'N H Shah', 'Xiaochun Li', 'Siu Hui', 'Patrick Ryan', 'Marc Rosenman', 'Marc Overhage', 'Frank J Defalco', 'Patrick B Ryan', 'M Soledad Cepeda', 'Xiaofeng Zhou', 'Sundaresan Murugesan', 'Harshvinder Bhullar', 'Qing Liu', 'Bing Cai', 'Chuck Wentworth', 'Andrew Bate', 'Abraham G Hartzema', 'Christian G Reich', 'Patrick B Ryan', 'Paul E Stang', 'David Madigan', 'Emily Welebob', 'J Marc Overhage', 'Christian G Reich', 'Patrick B Ryan', 'Marc A Suchard', 'Paul E Stang', 'Patrick B Ryan', 'J Marc Overhage', 'Martijn J Schuemie', 'Abraham G Hartzema', 'Emily Welebob', 'David Madigan', 'Patrick B Ryan', 'Martijn Schuemie'","['A Bauer-Mehren', 'Abraham G Hartzema', 'Andrew Bate', 'Aziz Boxwala', 'Bing Cai', 'Christian Reich', 'Chuck Wentworth', 'Daniella Meeker', 'David Madigan', 'Emily Welebob', 'Francesco Innocenti', 'Frank J Defalco', 'Giampiero Mazzaglia', 'Gino Picelli', 'Harshvinder Bhullar', 'Huub Straatman', 'Hyeon-Eui Kim', 'J Marc Overhage', 'James J Cimino', 'Johan van der Lei', 'Judith A Racoosin', 'Kevin G Moores', 'Lars Pedersen', 'Lian Lian Duan', 'M Soledad Cepeda', 'Marc A Suchard', 'Marc Rosenman', 'Martijn J Schuemie', 'Mei Liu', 'Miriam C J M Sturkenboom', 'Mitra Rocca', 'Mohammad Khoshneshin', 'N H Shah', 'Naveen Ashish', 'Omolola I Ogunyemi', 'P LePendu', 'P Ryan', 'Patrick B Ryan', 'Paul E Stang', 'Preciosa M Coloma', 'Qing Liu', 'R Harpaz', 'Ron M C Herings', 'Rosa Gini', 'Ryan M Carnahan', 'Seena Farzaneh', 'Siu Hui', 'Sundaresan Murugesan', 'Vojtech Huser', 'W DuMouchel', 'W Nick Street', 'Xiaochun Li', 'Xiaofeng Zhou']",43,53
2,2014,"S Vilar, Richard D Boyce, Peter R Rijnbeek, Amy Matcho, G Trifiro, Rupa Makadia, Richard A Hansen, R W White, Martijn J Schuemie, Martijn J Schuemie","['Abraham G Hartzema', 'Amy Matcho', 'Christian Reich', 'Frank J Defalco', 'G Trifiro', 'Lian Lian Duan', 'Martijn J Schuemie', 'Omolola I Ogunyemi', 'Patrick B Ryan', 'Paul E Stang', 'Peter R Rijnbeek', 'R Harpaz', 'R W White', 'Richard A Hansen', 'Richard D Boyce', 'Rupa Makadia', 'Ryan M Carnahan', 'S Vilar', 'Vojtech Huser', 'Xiaochun Li', 'Xiaofeng Zhou']",8,21,"['S, Vilar', 'P B, Ryan', 'D, Madigan', 'P E, Stang', 'M J, Schuemie', 'C, Friedman', 'N P, Tatonetti', 'G, Hripcsak'], ['Richard D, Boyce', 'Patrick B, Ryan', 'G Niklas, Noren', 'Martijn J, Schuemie', 'Christian, Reich', 'Jon, Duke', 'Nicholas P, Tatonetti', 'Gianluca, Trifiro', 'Rave, Harpaz', 'J Marc, Overhage', 'Abraham G, Hartzema', 'Mark, Khayter', 'Erica A, Voss', 'Christophe G, Lambert', 'Vojtech, Huser', 'Michel, Dumontier'], ['Peter R, Rijnbeek'], ['Amy, Matcho', 'Patrick, Ryan', 'Daniel, Fife', 'Christian, Reich'], ['G, Trifiro', 'P M, Coloma', 'P R, Rijnbeek', 'S, Romio', 'B, Mosseveld', 'D, Weibel', 'J, Bonhoeffer', 'M, Schuemie', 'J, van der Lei', 'M, Sturkenboom'], ['Rupa, Makadia', 'Patrick B, Ryan'], ['Richard A, Hansen', 'Peng, Zeng', 'Patrick, Ryan', 'Juan, Gao', 'Kalyani, Sonawane', 'Benjamin, Teeter', 'Kimberly, Westrich', 'Robert W, Dubois'], ['R W, White', 'R, Harpaz', 'N H, Shah', 'W, DuMouchel', 'E, Horvitz'], ['Martijn J, Schuemie', 'Patrick B, Ryan', 'Marc A, Suchard', 'Zach, Shahn', 'David, Madigan'], ['Martijn J, Schuemie', 'Patrick B, Ryan', 'William, DuMouchel', 'Marc A, Suchard', 'David, Madigan']","'S Vilar', 'P B Ryan', 'D Madigan', 'P E Stang', 'M J Schuemie', 'C Friedman', 'N P Tatonetti', 'G Hripcsak', 'Richard D Boyce', 'Patrick B Ryan', 'G Niklas Noren', 'Martijn J Schuemie', 'Christian Reich', 'Jon Duke', 'Nicholas P Tatonetti', 'Gianluca Trifiro', 'Rave Harpaz', 'J Marc Overhage', 'Abraham G Hartzema', 'Mark Khayter', 'Erica A Voss', 'Christophe G Lambert', 'Vojtech Huser', 'Michel Dumontier', 'Peter R Rijnbeek', 'Amy Matcho', 'Patrick Ryan', 'Daniel Fife', 'Christian Reich', 'G Trifiro', 'P M Coloma', 'P R Rijnbeek', 'S Romio', 'B Mosseveld', 'D Weibel', 'J Bonhoeffer', 'M Schuemie', 'J van der Lei', 'M Sturkenboom', 'Rupa Makadia', 'Patrick B Ryan', 'Richard A Hansen', 'Peng Zeng', 'Patrick Ryan', 'Juan Gao', 'Kalyani Sonawane', 'Benjamin Teeter', 'Kimberly Westrich', 'Robert W Dubois', 'R W White', 'R Harpaz', 'N H Shah', 'W DuMouchel', 'E Horvitz', 'Martijn J Schuemie', 'Patrick B Ryan', 'Marc A Suchard', 'Zach Shahn', 'David Madigan', 'Martijn J Schuemie', 'Patrick B Ryan', 'William DuMouchel', 'Marc A Suchard', 'David Madigan'","['A Bauer-Mehren', 'Abraham G Hartzema', 'Amy Matcho', 'Andrew Bate', 'Aziz Boxwala', 'B Mosseveld', 'Benjamin Teeter', 'Bing Cai', 'C Friedman', 'Christian Reich', 'Christophe G Lambert', 'Chuck Wentworth', 'D Madigan', 'D Weibel', 'Daniel Fife', 'Daniella Meeker', 'David Madigan', 'E Horvitz', 'Emily Welebob', 'Erica A Voss', 'Francesco Innocenti', 'Frank J Defalco', 'G Hripcsak', 'G Niklas Noren', 'G Trifiro', 'Giampiero Mazzaglia', 'Gianluca Trifiro', 'Gino Picelli', 'Harshvinder Bhullar', 'Huub Straatman', 'Hyeon-Eui Kim', 'J Bonhoeffer', 'J Marc Overhage', 'J van der Lei', 'James J Cimino', 'Johan van der Lei', 'Jon Duke', 'Juan Gao', 'Judith A Racoosin', 'Kalyani Sonawane', 'Kevin G Moores', 'Kimberly Westrich', 'Lars Pedersen', 'Lian Lian Duan', 'M J Schuemie', 'M Soledad Cepeda', 'Marc A Suchard', 'Marc Rosenman', 'Mark Khayter', 'Martijn J Schuemie', 'Mei Liu', 'Michel Dumontier', 'Miriam C J M Sturkenboom', 'Mitra Rocca', 'Mohammad Khoshneshin', 'N H Shah', 'N P Tatonetti', 'Naveen Ashish', 'Nicholas P Tatonetti', 'Omolola I Ogunyemi', 'P E Stang', 'P LePendu', 'P M Coloma', 'P R Rijnbeek', 'P Ryan', 'Patrick B Ryan', 'Paul E Stang', 'Peng Zeng', 'Peter R Rijnbeek', 'Preciosa M Coloma', 'Qing Liu', 'R Harpaz', 'R W White', 'Rave Harpaz', 'Richard A Hansen', 'Richard D Boyce', 'Robert W Dubois', 'Ron M C Herings', 'Rosa Gini', 'Rupa Makadia', 'Ryan M Carnahan', 'S Romio', 'S Vilar', 'Seena Farzaneh', 'Siu Hui', 'Sundaresan Murugesan', 'Vojtech Huser', 'W DuMouchel', 'W Nick Street', 'William DuMouchel', 'Xiaochun Li', 'Xiaofeng Zhou', 'Zach Shahn']",40,93
3,2015,"George Hripcsak, Ying Li, Santiago Vilar, Mary Regina Boland, Mary Regina Boland, Hong Sun, F FitzHenry, Edeltraut Garbe, Yihua Xu, Erica A Voss, Erica A Voss, Mohammed Khalilia, Yihua Xu, Mary Regina Boland, Michael G Kahn","['Abraham G Hartzema', 'Amy Matcho', 'Christian Reich', 'Edeltraut Garbe', 'Erica A Voss', 'F FitzHenry', 'Frank J Defalco', 'G Trifiro', 'George Hripcsak', 'Hong Sun', 'Lian Lian Duan', 'Martijn J Schuemie', 'Mary Regina Boland', 'Mohammed Khalilia', 'Omolola I Ogunyemi', 'Patrick B Ryan', 'Paul E Stang', 'Peter R Rijnbeek', 'R Harpaz', 'R W White', 'Richard A Hansen', 'Richard D Boyce', 'Rupa Makadia', 'Ryan M Carnahan', 'S Vilar', 'Santiago Vilar', 'Vojtech Huser', 'Xiaochun Li', 'Xiaofeng Zhou', 'Yihua Xu', 'Ying Li']",10,31,"['George, Hripcsak', 'Jon D, Duke', 'Nigam H, Shah', 'Christian G, Reich', 'Vojtech, Huser', 'Martijn J, Schuemie', 'Marc A, Suchard', 'Rae Woong, Park', 'Ian Chi Kei, Wong', 'Peter R, Rijnbeek', 'Johan, van der Lei', 'Nicole, Pratt', 'G Niklas, Noren', 'Yu-Chuan, Li', 'Paul E, Stang', 'David, Madigan', 'Patrick B, Ryan'], ['Ying, Li', 'Patrick B, Ryan', 'Ying, Wei', 'Carol, Friedman'], ['Santiago, Vilar', 'Tal, Lorberbaum', 'George, Hripcsak', 'Nicholas P, Tatonetti'], ['Mary Regina, Boland', 'Zachary, Shahn', 'David, Madigan', 'George, Hripcsak', 'Nicholas P, Tatonetti'], ['Mary Regina, Boland', 'Nicholas P, Tatonetti', 'George, Hripcsak'], ['Hong, Sun', 'Kristof, Depraetere', 'Jos, De Roo', 'Giovanni, Mels', 'Boris, De Vloed', 'Marc, Twagirumukiza', 'Dirk, Colaert'], ['F, FitzHenry', 'F S, Resnic', 'S L, Robbins', 'J, Denton', 'L, Nookala', 'D, Meeker', 'L, Ohno-Machado', 'M E, Matheny'], ['Edeltraut, Garbe', 'Iris, Pigeot'], ['Yihua, Xu', 'Xiaofeng, Zhou', 'Brandon T, Suehs', 'Abraham G, Hartzema', 'Michael G, Kahn', 'Yola, Moride', 'Brian C, Sauer', 'Qing, Liu', 'Keran, Moll', 'Margaret K, Pasquale', 'Vinit P, Nair', 'Andrew, Bate'], ['Erica A, Voss', 'Qianli, Ma', 'Patrick B, Ryan'], ['Erica A, Voss', 'Rupa, Makadia', 'Amy, Matcho', 'Qianli, Ma', 'Chris, Knoll', 'Martijn, Schuemie', 'Frank J, DeFalco', 'Ajit, Londhe', 'Vivienne, Zhu', 'Patrick B, Ryan'], ['Mohammed, Khalilia', 'Myung, Choi', 'Amelia, Henderson', 'Sneha, Iyengar', 'Mark, Braunstein', 'Jimeng, Sun'], ['Yihua, Xu', 'Xiaofeng, Zhou', 'Brandon T, Suehs', 'Abraham G, Hartzema', 'Michael G, Kahn', 'Yola, Moride', 'Brian C, Sauer', 'Qing, Liu', 'Keran, Moll', 'Margaret K, Pasquale', 'Vinit P, Nair', 'Andrew, Bate'], ['Mary Regina, Boland', 'Nicholas P, Tatonetti'], ['Michael G, Kahn', 'Jeffrey S, Brown', 'Alein T, Chun', 'Bruce N, Davidson', 'Daniella, Meeker', 'Patrick B, Ryan', 'Lisa M, Schilling', 'Nicole G, Weiskopf', 'Andrew E, Williams', 'Meredith Nahm, Zozus']","'George Hripcsak', 'Jon D Duke', 'Nigam H Shah', 'Christian G Reich', 'Vojtech Huser', 'Martijn J Schuemie', 'Marc A Suchard', 'Rae Woong Park', 'Ian Chi Kei Wong', 'Peter R Rijnbeek', 'Johan van der Lei', 'Nicole Pratt', 'G Niklas Noren', 'Yu-Chuan Li', 'Paul E Stang', 'David Madigan', 'Patrick B Ryan', 'Ying Li', 'Patrick B Ryan', 'Ying Wei', 'Carol Friedman', 'Santiago Vilar', 'Tal Lorberbaum', 'George Hripcsak', 'Nicholas P Tatonetti', 'Mary Regina Boland', 'Zachary Shahn', 'David Madigan', 'George Hripcsak', 'Nicholas P Tatonetti', 'Mary Regina Boland', 'Nicholas P Tatonetti', 'George Hripcsak', 'Hong Sun', 'Kristof Depraetere', 'Jos De Roo', 'Giovanni Mels', 'Boris De Vloed', 'Marc Twagirumukiza', 'Dirk Colaert', 'F FitzHenry', 'F S Resnic', 'S L Robbins', 'J Denton', 'L Nookala', 'D Meeker', 'L Ohno-Machado', 'M E Matheny', 'Edeltraut Garbe', 'Iris Pigeot', 'Yihua Xu', 'Xiaofeng Zhou', 'Brandon T Suehs', 'Abraham G Hartzema', 'Michael G Kahn', 'Yola Moride', 'Brian C Sauer', 'Qing Liu', 'Keran Moll', 'Margaret K Pasquale', 'Vinit P Nair', 'Andrew Bate', 'Erica A Voss', 'Qianli Ma', 'Patrick B Ryan', 'Erica A Voss', 'Rupa Makadia', 'Amy Matcho', 'Qianli Ma', 'Chris Knoll', 'Martijn Schuemie', 'Frank J DeFalco', 'Ajit Londhe', 'Vivienne Zhu', 'Patrick B Ryan', 'Mohammed Khalilia', 'Myung Choi', 'Amelia Henderson', 'Sneha Iyengar', 'Mark Braunstein', 'Jimeng Sun', 'Yihua Xu', 'Xiaofeng Zhou', 'Brandon T Suehs', 'Abraham G Hartzema', 'Michael G Kahn', 'Yola Moride', 'Brian C Sauer', 'Qing Liu', 'Keran Moll', 'Margaret K Pasquale', 'Vinit P Nair', 'Andrew Bate', 'Mary Regina Boland', 'Nicholas P Tatonetti', 'Michael G Kahn', 'Jeffrey S Brown', 'Alein T Chun', 'Bruce N Davidson', 'Daniella Meeker', 'Patrick B Ryan', 'Lisa M Schilling', 'Nicole G Weiskopf', 'Andrew E Williams', 'Meredith Nahm Zozus'","['A Bauer-Mehren', 'Abraham G Hartzema', 'Ajit Londhe', 'Alein T Chun', 'Amelia Henderson', 'Amy Matcho', 'Andrew Bate', 'Andrew E Williams', 'Aziz Boxwala', 'B Mosseveld', 'Benjamin Teeter', 'Bing Cai', 'Boris De Vloed', 'Brandon T Suehs', 'Brian C Sauer', 'Bruce N Davidson', 'C Friedman', 'Carol Friedman', 'Chris Knoll', 'Christian Reich', 'Christophe G Lambert', 'Chuck Wentworth', 'D Madigan', 'D Meeker', 'D Weibel', 'Daniel Fife', 'Daniella Meeker', 'David Madigan', 'Dirk Colaert', 'E Horvitz', 'Edeltraut Garbe', 'Emily Welebob', 'Erica A Voss', 'F FitzHenry', 'F S Resnic', 'Francesco Innocenti', 'Frank J Defalco', 'G Hripcsak', 'G Niklas Noren', 'G Trifiro', 'George Hripcsak', 'Giampiero Mazzaglia', 'Gianluca Trifiro', 'Gino Picelli', 'Giovanni Mels', 'Harshvinder Bhullar', 'Hong Sun', 'Huub Straatman', 'Hyeon-Eui Kim', 'Ian Chi Kei Wong', 'Iris Pigeot', 'J Bonhoeffer', 'J Denton', 'J Marc Overhage', 'J van der Lei', 'James J Cimino', 'Jeffrey S Brown', 'Jimeng Sun', 'Johan van der Lei', 'Jon Duke', 'Jos De Roo', 'Juan Gao', 'Judith A Racoosin', 'Kalyani Sonawane', 'Keran Moll', 'Kevin G Moores', 'Kimberly Westrich', 'Kristof Depraetere', 'L Nookala', 'L Ohno-Machado', 'Lars Pedersen', 'Lian Lian Duan', 'Lisa M Schilling', 'M E Matheny', 'M J Schuemie', 'M Soledad Cepeda', 'Marc A Suchard', 'Marc Rosenman', 'Marc Twagirumukiza', 'Margaret K Pasquale', 'Mark Braunstein', 'Mark Khayter', 'Martijn J Schuemie', 'Mary Regina Boland', 'Mei Liu', 'Michael G Kahn', 'Michel Dumontier', 'Miriam C J M Sturkenboom', 'Mitra Rocca', 'Mohammad Khoshneshin', 'Mohammed Khalilia', 'Myung Choi', 'N H Shah', 'N P Tatonetti', 'Naveen Ashish', 'Nicholas P Tatonetti', 'Nicole G Weiskopf', 'Nicole Pratt', 'Nigam H Shah', 'Omolola I Ogunyemi', 'P E Stang', 'P LePendu', 'P M Coloma', 'P R Rijnbeek', 'P Ryan', 'Patrick B Ryan', 'Paul E Stang', 'Peng Zeng', 'Peter R Rijnbeek', 'Preciosa M Coloma', 'Qianli Ma', 'Qing Liu', 'R Harpaz', 'R W White', 'Rae Woong Park', 'Rave Harpaz', 'Richard A Hansen', 'Richard D Boyce', 'Robert W Dubois', 'Ron M C Herings', 'Rosa Gini', 'Rupa Makadia', 'Ryan M Carnahan', 'S L Robbins', 'S Romio', 'S Vilar', 'Santiago Vilar', 'Seena Farzaneh', 'Siu Hui', 'Sneha Iyengar', 'Sundaresan Murugesan', 'Tal Lorberbaum', 'Vinit P Nair', 'Vivienne Zhu', 'Vojtech Huser', 'W DuMouchel', 'W Nick Street', 'William DuMouchel', 'Xiaochun Li', 'Xiaofeng Zhou', 'Yihua Xu', 'Ying Li', 'Ying Wei', 'Yola Moride', 'Yu-Chuan Li', 'Zach Shahn', 'Zachary Shahn']",54,147
4,2016,"Vojtech Huser, Rosa Gini, Richard D Boyce, Anando Sen, Martijn J Schuemie, George Hripcsak, Rosa Gini, Dukyong Yoon, Mary Regina Boland, Hyeoneui Kim, Maryam Garza, Susan Gruber, Susan Gruber, Manfred Hauben, Martijn J Schuemie, Matthias Samwald, Nir Nissim, Dukyong Yoon","['Abraham G Hartzema', 'Amy Matcho', 'Anando Sen', 'Christian Reich', 'Dukyong Yoon', 'Edeltraut Garbe', 'Erica A Voss', 'F FitzHenry', 'Frank J Defalco', 'G Trifiro', 'George Hripcsak', 'Hong Sun', 'Hyeoneui Kim', 'Lian Lian Duan', 'Manfred Hauben', 'Martijn J Schuemie', 'Mary Regina Boland', 'Maryam Garza', 'Matthias Samwald', 'Mohammed Khalilia', 'Nir Nissim', 'Omolola I Ogunyemi', 'Patrick B Ryan', 'Paul E Stang', 'Peter R Rijnbeek', 'R Harpaz', 'R W White', 'Richard A Hansen', 'Richard D Boyce', 'Rosa Gini', 'Rupa Makadia', 'Ryan M Carnahan', 'S Vilar', 'Santiago Vilar', 'Susan Gruber', 'Vojtech Huser', 'Xiaochun Li', 'Xiaofeng Zhou', 'Yihua Xu', 'Ying Li']",9,40,"['Vojtech, Huser', 'Frank J, DeFalco', 'Martijn, Schuemie', 'Patrick B, Ryan', 'Ning, Shang', 'Mark, Velez', 'Rae Woong, Park', 'Richard D, Boyce', 'Jon, Duke', 'Ritu, Khare', 'Levon, Utidjian', 'Charles, Bailey'], ['Rosa, Gini', 'Martijn J, Schuemie', 'Giampiero, Mazzaglia', 'Francesco, Lapi', 'Paolo, Francesconi', 'Alessandro, Pasqua', 'Elisa, Bianchini', 'Carmelo, Montalbano', 'Giuseppe, Roberto', 'Valentina, Barletta', 'Iacopo, Cricelli', 'Claudio, Cricelli', 'Giulia, Dal Co', 'Mariadonata, Bellentani', 'Miriam, Sturkenboom', 'Niek, Klazinga'], ['Richard D, Boyce', 'Steven M, Handler', 'Jordan F, Karp', 'Subashan, Perera', 'Charles F 3rd, Reynolds'], ['Anando, Sen', 'Shreya, Chakrabarti', 'Andrew, Goldstein', 'Shuang, Wang', 'Patrick B, Ryan', 'Chunhua, Weng'], ['Martijn J, Schuemie', 'George, Hripcsak', 'Patrick B, Ryan', 'David, Madigan', 'Marc A, Suchard'], ['George, Hripcsak', 'Patrick B, Ryan', 'Jon D, Duke', 'Nigam H, Shah', 'Rae Woong, Park', 'Vojtech, Huser', 'Marc A, Suchard', 'Martijn J, Schuemie', 'Frank J, DeFalco', 'Adler, Perotte', 'Juan M, Banda', 'Christian G, Reich', 'Lisa M, Schilling', 'Michael E, Matheny', 'Daniella, Meeker', 'Nicole, Pratt', 'David, Madigan'], ['Rosa, Gini', 'Martijn, Schuemie', 'Jeffrey, Brown', 'Patrick, Ryan', 'Edoardo, Vacchi', 'Massimo, Coppola', 'Walter, Cazzola', 'Preciosa, Coloma', 'Roberto, Berni', 'Gayo, Diallo', 'Jose Luis, Oliveira', 'Paul, Avillach', 'Gianluca, Trifiro', 'Peter, Rijnbeek', 'Mariadonata, Bellentani', 'Johan, van Der Lei', 'Niek, Klazinga', 'Miriam, Sturkenboom'], ['Dukyong, Yoon', 'Eun Kyoung, Ahn', 'Man Young, Park', 'Soo Yeon, Cho', 'Patrick, Ryan', 'Martijn J, Schuemie', 'Dahye, Shin', 'Hojun, Park', 'Rae Woong, Park'], ['Mary Regina, Boland', 'Alexandra, Jacunski', 'Tal, Lorberbaum', 'Joseph D, Romano', 'Robert, Moskovitch', 'Nicholas P, Tatonetti'], ['Hyeoneui, Kim', 'Jeeyae, Choi', 'Imho, Jang', 'Jimmy, Quach', 'Lucila, Ohno-Machado'], ['Maryam, Garza', 'Guilherme, Del Fiol', 'Jessica, Tenenbaum', 'Anita, Walden', 'Meredith Nahm, Zozus'], ['Susan, Gruber', 'Aloka, Chakravarty', 'Susan R, Heckbert', 'Mark, Levenson', 'David, Martin', 'Jennifer C, Nelson', 'Bruce M, Psaty', 'Simone, Pinheiro', 'Christian G, Reich', 'Sengwee, Toh', 'Alexander M, Walker'], ['Susan, Gruber', 'Eric, Tchetgen Tchetgen'], ['Manfred, Hauben', 'Jeffrey K, Aronson', 'Robin E, Ferner'], ['Martijn J, Schuemie', 'Gianluca, Trifiro', 'Preciosa M, Coloma', 'Patrick B, Ryan', 'David, Madigan'], ['Matthias, Samwald', 'Hong, Xu', 'Kathrin, Blagec', 'Philip E, Empey', 'Daniel C, Malone', 'Seid Mussa, Ahmed', 'Patrick, Ryan', 'Sebastian, Hofer', 'Richard D, Boyce'], ['Nir, Nissim', 'Mary Regina, Boland', 'Nicholas P, Tatonetti', 'Yuval, Elovici', 'George, Hripcsak', 'Yuval, Shahar', 'Robert, Moskovitch'], ['Dukyong, Yoon', 'Martijn J, Schuemie', 'Ju Han, Kim', 'Dong Ki, Kim', 'Man Young, Park', 'Eun Kyoung, Ahn', 'Eun-Young, Jung', 'Dong Kyun, Park', 'Soo Yeon, Cho', 'Dahye, Shin', 'Yeonsoo, Hwang', 'Rae Woong, Park']","'Vojtech Huser', 'Frank J DeFalco', 'Martijn Schuemie', 'Patrick B Ryan', 'Ning Shang', 'Mark Velez', 'Rae Woong Park', 'Richard D Boyce', 'Jon Duke', 'Ritu Khare', 'Levon Utidjian', 'Charles Bailey', 'Rosa Gini', 'Martijn J Schuemie', 'Giampiero Mazzaglia', 'Francesco Lapi', 'Paolo Francesconi', 'Alessandro Pasqua', 'Elisa Bianchini', 'Carmelo Montalbano', 'Giuseppe Roberto', 'Valentina Barletta', 'Iacopo Cricelli', 'Claudio Cricelli', 'Giulia Dal Co', 'Mariadonata Bellentani', 'Miriam Sturkenboom', 'Niek Klazinga', 'Richard D Boyce', 'Steven M Handler', 'Jordan F Karp', 'Subashan Perera', 'Charles F 3rd Reynolds', 'Anando Sen', 'Shreya Chakrabarti', 'Andrew Goldstein', 'Shuang Wang', 'Patrick B Ryan', 'Chunhua Weng', 'Martijn J Schuemie', 'George Hripcsak', 'Patrick B Ryan', 'David Madigan', 'Marc A Suchard', 'George Hripcsak', 'Patrick B Ryan', 'Jon D Duke', 'Nigam H Shah', 'Rae Woong Park', 'Vojtech Huser', 'Marc A Suchard', 'Martijn J Schuemie', 'Frank J DeFalco', 'Adler Perotte', 'Juan M Banda', 'Christian G Reich', 'Lisa M Schilling', 'Michael E Matheny', 'Daniella Meeker', 'Nicole Pratt', 'David Madigan', 'Rosa Gini', 'Martijn Schuemie', 'Jeffrey Brown', 'Patrick Ryan', 'Edoardo Vacchi', 'Massimo Coppola', 'Walter Cazzola', 'Preciosa Coloma', 'Roberto Berni', 'Gayo Diallo', 'Jose Luis Oliveira', 'Paul Avillach', 'Gianluca Trifiro', 'Peter Rijnbeek', 'Mariadonata Bellentani', 'Johan van Der Lei', 'Niek Klazinga', 'Miriam Sturkenboom', 'Dukyong Yoon', 'Eun Kyoung Ahn', 'Man Young Park', 'Soo Yeon Cho', 'Patrick Ryan', 'Martijn J Schuemie', 'Dahye Shin', 'Hojun Park', 'Rae Woong Park', 'Mary Regina Boland', 'Alexandra Jacunski', 'Tal Lorberbaum', 'Joseph D Romano', 'Robert Moskovitch', 'Nicholas P Tatonetti', 'Hyeoneui Kim', 'Jeeyae Choi', 'Imho Jang', 'Jimmy Quach', 'Lucila Ohno-Machado', 'Maryam Garza', 'Guilherme Del Fiol', 'Jessica Tenenbaum', 'Anita Walden', 'Meredith Nahm Zozus', 'Susan Gruber', 'Aloka Chakravarty', 'Susan R Heckbert', 'Mark Levenson', 'David Martin', 'Jennifer C Nelson', 'Bruce M Psaty', 'Simone Pinheiro', 'Christian G Reich', 'Sengwee Toh', 'Alexander M Walker', 'Susan Gruber', 'Eric Tchetgen Tchetgen', 'Manfred Hauben', 'Jeffrey K Aronson', 'Robin E Ferner', 'Martijn J Schuemie', 'Gianluca Trifiro', 'Preciosa M Coloma', 'Patrick B Ryan', 'David Madigan', 'Matthias Samwald', 'Hong Xu', 'Kathrin Blagec', 'Philip E Empey', 'Daniel C Malone', 'Seid Mussa Ahmed', 'Patrick Ryan', 'Sebastian Hofer', 'Richard D Boyce', 'Nir Nissim', 'Mary Regina Boland', 'Nicholas P Tatonetti', 'Yuval Elovici', 'George Hripcsak', 'Yuval Shahar', 'Robert Moskovitch', 'Dukyong Yoon', 'Martijn J Schuemie', 'Ju Han Kim', 'Dong Ki Kim', 'Man Young Park', 'Eun Kyoung Ahn', 'Eun-Young Jung', 'Dong Kyun Park', 'Soo Yeon Cho', 'Dahye Shin', 'Yeonsoo Hwang', 'Rae Woong Park'","['A Bauer-Mehren', 'Abraham G Hartzema', 'Adler Perotte', 'Ajit Londhe', 'Alein T Chun', 'Alessandro Pasqua', 'Alexander M Walker', 'Alexandra Jacunski', 'Aloka Chakravarty', 'Amelia Henderson', 'Amy Matcho', 'Anando Sen', 'Andrew Bate', 'Andrew E Williams', 'Andrew Goldstein', 'Anita Walden', 'Aziz Boxwala', 'B Mosseveld', 'Benjamin Teeter', 'Bing Cai', 'Boris De Vloed', 'Brandon T Suehs', 'Brian C Sauer', 'Bruce M Psaty', 'Bruce N Davidson', 'C Friedman', 'Carmelo Montalbano', 'Carol Friedman', 'Charles Bailey', 'Charles F 3rd Reynolds', 'Chris Knoll', 'Christian Reich', 'Christophe G Lambert', 'Chuck Wentworth', 'Chunhua Weng', 'Claudio Cricelli', 'D Madigan', 'D Meeker', 'D Weibel', 'Dahye Shin', 'Daniel C Malone', 'Daniel Fife', 'Daniella Meeker', 'David Madigan', 'David Martin', 'Dirk Colaert', 'Dong Ki Kim', 'Dong Kyun Park', 'Dukyong Yoon', 'E Horvitz', 'Edeltraut Garbe', 'Edoardo Vacchi', 'Elisa Bianchini', 'Emily Welebob', 'Eric Tchetgen Tchetgen', 'Erica A Voss', 'Eun Kyoung Ahn', 'Eun-Young Jung', 'F FitzHenry', 'F S Resnic', 'Francesco Innocenti', 'Francesco Lapi', 'Frank J Defalco', 'G Hripcsak', 'G Niklas Noren', 'G Trifiro', 'Gayo Diallo', 'George Hripcsak', 'Giampiero Mazzaglia', 'Gianluca Trifiro', 'Gino Picelli', 'Giovanni Mels', 'Giulia Dal Co', 'Giuseppe Roberto', 'Guilherme Del Fiol', 'Harshvinder Bhullar', 'Hojun Park', 'Hong Sun', 'Hong Xu', 'Huub Straatman', 'Hyeon-Eui Kim', 'Iacopo Cricelli', 'Ian Chi Kei Wong', 'Imho Jang', 'Iris Pigeot', 'J Bonhoeffer', 'J Denton', 'J Marc Overhage', 'J van der Lei', 'James J Cimino', 'Jeeyae Choi', 'Jeffrey K Aronson', 'Jeffrey S Brown', 'Jennifer C Nelson', 'Jessica Tenenbaum', 'Jimeng Sun', 'Jimmy Quach', 'Johan van der Lei', 'Jon Duke', 'Jordan F Karp', 'Jos De Roo', 'Jose Luis Oliveira', 'Joseph D Romano', 'Ju Han Kim', 'Juan Gao', 'Juan M Banda', 'Judith A Racoosin', 'Kalyani Sonawane', 'Kathrin Blagec', 'Keran Moll', 'Kevin G Moores', 'Kimberly Westrich', 'Kristof Depraetere', 'L Nookala', 'L Ohno-Machado', 'Lars Pedersen', 'Levon Utidjian', 'Lian Lian Duan', 'Lisa M Schilling', 'Lucila Ohno-Machado', 'M E Matheny', 'M J Schuemie', 'M Soledad Cepeda', 'Man Young Park', 'Manfred Hauben', 'Marc A Suchard', 'Marc Rosenman', 'Marc Twagirumukiza', 'Margaret K Pasquale', 'Mariadonata Bellentani', 'Mark Braunstein', 'Mark Khayter', 'Mark Levenson', 'Mark Velez', 'Martijn J Schuemie', 'Mary Regina Boland', 'Maryam Garza', 'Massimo Coppola', 'Matthias Samwald', 'Mei Liu', 'Meredith Nahm Zozus', 'Michael E Matheny', 'Michael G Kahn', 'Michel Dumontier', 'Miriam C J M Sturkenboom', 'Mitra Rocca', 'Mohammad Khoshneshin', 'Mohammed Khalilia', 'Myung Choi', 'N H Shah', 'N P Tatonetti', 'Naveen Ashish', 'Nicholas P Tatonetti', 'Nicole G Weiskopf', 'Nicole Pratt', 'Niek Klazinga', 'Nigam H Shah', 'Ning Shang', 'Nir Nissim', 'Omolola I Ogunyemi', 'P E Stang', 'P LePendu', 'P M Coloma', 'P R Rijnbeek', 'P Ryan', 'Paolo Francesconi', 'Patrick B Ryan', 'Paul Avillach', 'Paul E Stang', 'Peng Zeng', 'Peter R Rijnbeek', 'Philip E Empey', 'Preciosa M Coloma', 'Qianli Ma', 'Qing Liu', 'R Harpaz', 'R W White', 'Rae Woong Park', 'Rave Harpaz', 'Richard A Hansen', 'Richard D Boyce', 'Ritu Khare', 'Robert Moskovitch', 'Robert W Dubois', 'Roberto Berni', 'Robin E Ferner', 'Ron M C Herings', 'Rosa Gini', 'Rupa Makadia', 'Ryan M Carnahan', 'S L Robbins', 'S Romio', 'S Vilar', 'Santiago Vilar', 'Sebastian Hofer', 'Seena Farzaneh', 'Seid Mussa Ahmed', 'Sengwee Toh', 'Shreya Chakrabarti', 'Shuang Wang', 'Simone Pinheiro', 'Siu Hui', 'Sneha Iyengar', 'Soo Yeon Cho', 'Steven M Handler', 'Subashan Perera', 'Sundaresan Murugesan', 'Susan Gruber', 'Susan R Heckbert', 'Tal Lorberbaum', 'Valentina Barletta', 'Vinit P Nair', 'Vivienne Zhu', 'Vojtech Huser', 'W DuMouchel', 'W Nick Street', 'Walter Cazzola', 'William DuMouchel', 'Xiaochun Li', 'Xiaofeng Zhou', 'Yeonsoo Hwang', 'Yihua Xu', 'Ying Li', 'Ying Wei', 'Yola Moride', 'Yu-Chuan Li', 'Yuval Elovici', 'Yuval Shahar', 'Zach Shahn', 'Zachary Shahn']",83,230
5,2017,"Guoqian Jiang, Guoqian Jiang, Seng Chan You, Rosa Gini, Robert Moskovitch, Juan M Banda, Jon D Duke, nan, E A Voss, Yuqi Si, S T Rosenbloom, Toan C Ong, Shreya Chakrabarti, Werner Ceusters, Tian Kang, Jonathan C Blaisure, Zhaobin Kuang, Tiffany J Callahan, Nir Nissim, Rae Woong Park, Mary Regina Boland","['Abraham G Hartzema', 'Amy Matcho', 'Anando Sen', 'Christian Reich', 'Dukyong Yoon', 'E A Voss', 'Edeltraut Garbe', 'Erica A Voss', 'F FitzHenry', 'Frank J Defalco', 'G Trifiro', 'George Hripcsak', 'Guoqian Jiang', 'Hong Sun', 'Hyeoneui Kim', 'Jon D Duke', 'Jonathan C Blaisure', 'Juan M Banda', 'Lian Lian Duan', 'Manfred Hauben', 'Martijn J Schuemie', 'Mary Regina Boland', 'Maryam Garza', 'Matthias Samwald', 'Mohammed Khalilia', 'Nir Nissim', 'Omolola I Ogunyemi', 'Patrick B Ryan', 'Paul E Stang', 'Peter R Rijnbeek', 'R Harpaz', 'R W White', 'Rae Woong Park', 'Richard A Hansen', 'Richard D Boyce', 'Robert Moskovitch', 'Rosa Gini', 'Rupa Makadia', 'Ryan M Carnahan', 'S T Rosenbloom', 'S Vilar', 'Santiago Vilar', 'Seng Chan You', 'Shreya Chakrabarti', 'Susan Gruber', 'Tian Kang', 'Tiffany J Callahan', 'Toan C Ong', 'Vojtech Huser', 'Werner Ceusters', 'Xiaochun Li', 'Xiaofeng Zhou', 'Yihua Xu', 'Ying Li', 'Yuqi Si', 'Zhaobin Kuang', 'nan']",17,57,"['Guoqian, Jiang', 'Richard, Kiefer', ', hommeaux, Eric""', ], ['Guoqian, Jiang', 'Richard C, Kiefer', 'Deepak K, Sharma', ', hommeaux, Eric""', ], ['Seng Chan, You', 'Seongwon, Lee', 'Soo-Yeon, Cho', 'Hojun, Park', 'Sungjae, Jung', 'Jaehyeong, Cho', 'Dukyong, Yoon', 'Rae Woong, Park'], ['Rosa, Gini', 'Martijn J, Schuemie', 'Alessandro, Pasqua', 'Emanuele, Carlini', 'Francesco, Profili', 'Iacopo, Cricelli', 'Patrizio, Dazzi', 'Valentina, Barletta', 'Paolo, Francesconi', 'Francesco, Lapi', 'Andrea, Donatini', 'Giulia, Dal Co', 'Modesta, Visca', 'Mariadonata, Bellentani', 'Miriam, Sturkenboom', 'Niek, Klazinga'], ['Robert, Moskovitch', 'Fernanda, Polubriaginof', 'Aviram, Weiss', 'Patrick, Ryan', 'Nicholas, Tatonetti'], ['Juan M, Banda', 'Yoni, Halpern', 'David, Sontag', 'Nigam H, Shah'], ['Jon D, Duke', 'Patrick B, Ryan', 'Marc A, Suchard', 'George, Hripcsak', 'Peng, Jin', 'Christian, Reich', 'Marie-Sophie, Schwalm', 'Yuriy, Khoma', 'Yonghui, Wu', 'Hua, Xu', 'Nigam H, Shah', 'Juan M, Banda', 'Martijn J, Schuemie'], [], ['E A, Voss', 'R D, Boyce', 'P B, Ryan', 'J, van der Lei', 'P R, Rijnbeek', 'M J, Schuemie'], ['Yuqi, Si', 'Chunhua, Weng'], ['S T, Rosenbloom', 'R J, Carroll', 'J L, Warner', 'M E, Matheny', 'J C, Denny'], ['Toan C, Ong', 'Michael G, Kahn', 'Bethany M, Kwan', 'Traci, Yamashita', 'Elias, Brandt', 'Patrick, Hosokawa', 'Chris, Uhrich', 'Lisa M, Schilling'], ['Shreya, Chakrabarti', 'Anando, Sen', 'Vojtech, Huser', 'Gregory W, Hruby', 'Alexander, Rusanov', 'David J, Albers', 'Chunhua, Weng'], ['Werner, Ceusters', 'Jonathan, Blaisure'], ['Tian, Kang', 'Shaodian, Zhang', 'Youlan, Tang', 'Gregory W, Hruby', 'Alexander, Rusanov', 'Noemie, Elhadad', 'Chunhua, Weng'], ['Jonathan C, Blaisure', 'Werner M, Ceusters'], ['Zhaobin, Kuang', 'Peggy, Peissig', 'Vitor Santos, Costa', 'Richard, Maclin', 'David, Page'], ['Tiffany J, Callahan', 'Alan E, Bauck', 'David, Bertoch', 'Jeff, Brown', 'Ritu, Khare', 'Patrick B, Ryan', 'Jenny, Staab', 'Meredith N, Zozus', 'Michael G, Kahn'], ['Nir, Nissim', 'Yuval, Shahar', 'Yuval, Elovici', 'George, Hripcsak', 'Robert, Moskovitch'], ['Rae Woong, Park'], ['Mary Regina, Boland', 'Konrad J, Karczewski', 'Nicholas P, Tatonetti']","'Guoqian Jiang', 'Richard Kiefer', ', hommeaux Eric""', , 'Guoqian Jiang', 'Richard C Kiefer', 'Deepak K Sharma', ', hommeaux Eric""', , 'Seng Chan You', 'Seongwon Lee', 'Soo-Yeon Cho', 'Hojun Park', 'Sungjae Jung', 'Jaehyeong Cho', 'Dukyong Yoon', 'Rae Woong Park', 'Rosa Gini', 'Martijn J Schuemie', 'Alessandro Pasqua', 'Emanuele Carlini', 'Francesco Profili', 'Iacopo Cricelli', 'Patrizio Dazzi', 'Valentina Barletta', 'Paolo Francesconi', 'Francesco Lapi', 'Andrea Donatini', 'Giulia Dal Co', 'Modesta Visca', 'Mariadonata Bellentani', 'Miriam Sturkenboom', 'Niek Klazinga', 'Robert Moskovitch', 'Fernanda Polubriaginof', 'Aviram Weiss', 'Patrick Ryan', 'Nicholas Tatonetti', 'Juan M Banda', 'Yoni Halpern', 'David Sontag', 'Nigam H Shah', 'Jon D Duke', 'Patrick B Ryan', 'Marc A Suchard', 'George Hripcsak', 'Peng Jin', 'Christian Reich', 'Marie-Sophie Schwalm', 'Yuriy Khoma', 'Yonghui Wu', 'Hua Xu', 'Nigam H Shah', 'Juan M Banda', 'Martijn J Schuemie', , 'E A Voss', 'R D Boyce', 'P B Ryan', 'J van der Lei', 'P R Rijnbeek', 'M J Schuemie', 'Yuqi Si', 'Chunhua Weng', 'S T Rosenbloom', 'R J Carroll', 'J L Warner', 'M E Matheny', 'J C Denny', 'Toan C Ong', 'Michael G Kahn', 'Bethany M Kwan', 'Traci Yamashita', 'Elias Brandt', 'Patrick Hosokawa', 'Chris Uhrich', 'Lisa M Schilling', 'Shreya Chakrabarti', 'Anando Sen', 'Vojtech Huser', 'Gregory W Hruby', 'Alexander Rusanov', 'David J Albers', 'Chunhua Weng', 'Werner Ceusters', 'Jonathan Blaisure', 'Tian Kang', 'Shaodian Zhang', 'Youlan Tang', 'Gregory W Hruby', 'Alexander Rusanov', 'Noemie Elhadad', 'Chunhua Weng', 'Jonathan C Blaisure', 'Werner M Ceusters', 'Zhaobin Kuang', 'Peggy Peissig', 'Vitor Santos Costa', 'Richard Maclin', 'David Page', 'Tiffany J Callahan', 'Alan E Bauck', 'David Bertoch', 'Jeff Brown', 'Ritu Khare', 'Patrick B Ryan', 'Jenny Staab', 'Meredith N Zozus', 'Michael G Kahn', 'Nir Nissim', 'Yuval Shahar', 'Yuval Elovici', 'George Hripcsak', 'Robert Moskovitch', 'Rae Woong Park', 'Mary Regina Boland', 'Konrad J Karczewski', 'Nicholas P Tatonetti'","['A Bauer-Mehren', 'Abraham G Hartzema', 'Adler Perotte', 'Ajit Londhe', 'Alan E Bauck', 'Alein T Chun', 'Alessandro Pasqua', 'Alexander M Walker', 'Alexander Rusanov', 'Alexandra Jacunski', 'Aloka Chakravarty', 'Amelia Henderson', 'Amy Matcho', 'Anando Sen', 'Andrea Donatini', 'Andrew Bate', 'Andrew E Williams', 'Andrew Goldstein', 'Anita Walden', 'Aviram Weiss', 'Aziz Boxwala', 'B Mosseveld', 'Benjamin Teeter', 'Bethany M Kwan', 'Bing Cai', 'Boris De Vloed', 'Brandon T Suehs', 'Brian C Sauer', 'Bruce M Psaty', 'Bruce N Davidson', 'C Friedman', 'Carmelo Montalbano', 'Carol Friedman', 'Charles Bailey', 'Charles F 3rd Reynolds', 'Chris Knoll', 'Chris Uhrich', 'Christian Reich', 'Christophe G Lambert', 'Chuck Wentworth', 'Chunhua Weng', 'Claudio Cricelli', 'D Madigan', 'D Meeker', 'D Weibel', 'Dahye Shin', 'Daniel C Malone', 'Daniel Fife', 'Daniella Meeker', 'David Bertoch', 'David J Albers', 'David Madigan', 'David Martin', 'David Page', 'David Sontag', 'Deepak K Sharma', 'Dirk Colaert', 'Dong Ki Kim', 'Dong Kyun Park', 'Dukyong Yoon', 'E A Vos', 'E Horvitz', 'Edeltraut Garbe', 'Edoardo Vacchi', 'Elias Brandt', 'Elisa Bianchini', 'Emanuele Carlini', 'Emily Welebob', 'Eric Tchetgen Tchetgen', 'Erica A Voss', 'Eun Kyoung Ahn', 'Eun-Young Jung', 'F FitzHenry', 'F S Resnic', 'Fernanda Polubriaginof', 'Francesco Innocenti', 'Francesco Lapi', 'Francesco Profili', 'Frank J Defalco', 'G Hripcsak', 'G Niklas Noren', 'G Trifiro', 'Gayo Diallo', 'George Hripcsak', 'Giampiero Mazzaglia', 'Gianluca Trifiro', 'Gino Picelli', 'Giovanni Mels', 'Giulia Dal Co', 'Giuseppe Roberto', 'Gregory W Hruby', 'Guilherme Del Fiol', 'Guoqian Jiang', 'Harshvinder Bhullar', 'Hojun Park', 'Hong Sun', 'Hong Xu', 'Hua Xu', 'Huub Straatman', 'Hyeon-Eui Kim', 'Iacopo Cricelli', 'Ian Chi Kei Wong', 'Imho Jang', 'Iris Pigeot', 'J Bonhoeffer', 'J C Denny', 'J Denton', 'J L Warner', 'J Marc Overhage', 'J van der Lei', 'Jaehyeong Cho', 'James J Cimino', 'Jeeyae Choi', 'Jeff Brown', 'Jeffrey K Aronson', 'Jeffrey S Brown', 'Jennifer C Nelson', 'Jenny Staab', 'Jessica Tenenbaum', 'Jimeng Sun', 'Jimmy Quach', 'Johan van der Lei', 'Jon Duke', 'Jonathan Blaisure', 'Jordan F Karp', 'Jos De Roo', 'Jose Luis Oliveira', 'Joseph D Romano', 'Ju Han Kim', 'Juan Gao', 'Juan M Banda', 'Judith A Racoosin', 'Kalyani Sonawane', 'Kathrin Blagec', 'Keran Moll', 'Kevin G Moores', 'Kimberly Westrich', 'Konrad J Karczewski', 'Kristof Depraetere', 'L Nookala', 'L Ohno-Machado', 'Lars Pedersen', 'Levon Utidjian', 'Lian Lian Duan', 'Lisa M Schilling', 'Lucila Ohno-Machado', 'M E Matheny', 'M J Schuemie', 'M Soledad Cepeda', 'Man Young Park', 'Manfred Hauben', 'Marc A Suchard', 'Marc Rosenman', 'Marc Twagirumukiza', 'Margaret K Pasquale', 'Mariadonata Bellentani', 'Marie-Sophie Schwalm', 'Mark Braunstein', 'Mark Khayter', 'Mark Levenson', 'Mark Velez', 'Martijn J Schuemie', 'Mary Regina Boland', 'Maryam Garza', 'Massimo Coppola', 'Matthias Samwald', 'Mei Liu', 'Meredith N Zozus', 'Meredith Nahm Zozus', 'Michael E Matheny', 'Michael G Kahn', 'Michel Dumontier', 'Miriam C J M Sturkenboom', 'Mitra Rocca', 'Modesta Visca', 'Mohammad Khoshneshin', 'Mohammed Khalilia', 'Myung Choi', 'N H Shah', 'N P Tatonetti', 'Naveen Ashish', 'Nicholas P Tatonetti', 'Nicole G Weiskopf', 'Nicole Pratt', 'Niek Klazinga', 'Nigam H Shah', 'Ning Shang', 'Nir Nissim', 'Noemie Elhadad', 'Omolola I Ogunyemi', 'P E Stang', 'P LePendu', 'P M Coloma', 'P R Rijnbeek', 'P Ryan', 'Paolo Francesconi', 'Patrick B Ryan', 'Patrick Hosokawa', 'Patrizio Dazzi', 'Paul Avillach', 'Paul E Stang', 'Peggy Peissig', 'Peng Jin', 'Peng Zeng', 'Peter R Rijnbeek', 'Philip E Empey', 'Preciosa M Coloma', 'Qianli Ma', 'Qing Liu', 'R D Boyce', 'R Harpaz', 'R J Carroll', 'R W White', 'Rae Woong Park', 'Rave Harpaz', 'Richard A Hansen', 'Richard D Boyce', 'Richard Kiefer', 'Richard Maclin', 'Ritu Khare', 'Robert Moskovitch', 'Robert W Dubois', 'Roberto Berni', 'Robin E Ferner', 'Ron M C Herings', 'Rosa Gini', 'Rupa Makadia', 'Ryan M Carnahan', 'S L Robbins', 'S Romio', 'S T Rosenbloom', 'S Vilar', 'Santiago Vilar', 'Sebastian Hofer', 'Seena Farzaneh', 'Seid Mussa Ahmed', 'Seng Chan Yo', 'Sengwee Toh', 'Seongwon Lee', 'Shaodian Zhang', 'Shreya Chakrabarti', 'Shuang Wang', 'Simone Pinheiro', 'Siu Hui', 'Sneha Iyengar', 'Soo Yeon Cho', 'Steven M Handler', 'Subashan Perera', 'Sundaresan Murugesan', 'Sungjae Jung', 'Susan Gruber', 'Susan R Heckbert', 'Tal Lorberbaum', 'Tian Kang', 'Tiffany J Callahan', 'Toan C Ong', 'Traci Yamashita', 'Valentina Barletta', 'Vinit P Nair', 'Vitor Santos Costa', 'Vivienne Zhu', 'Vojtech Huser', 'W DuMouchel', 'W Nick Street', 'Walter Cazzola', 'Werner Ceusters', 'William DuMouchel', 'Xiaochun Li', 'Xiaofeng Zhou', 'Yeonsoo Hwang', 'Yihua Xu', 'Ying Li', 'Ying Wei', 'Yola Moride', 'Yonghui Wu', 'Yoni Halpern', 'Youlan Tang', 'Yu-Chuan Li', 'Yuqi Si', 'Yuriy Khoma', 'Yuval Elovici', 'Yuval Shahar', 'Zach Shahn', 'Zachary Shahn', 'Zhaobin Kuang', 'hommeaux Eri']",56,286
6,2018,"Martin G Seneviratne, Rohit Vashisht, Na Hong, Casey N Ta, Xin Zhang, George Hripcsak, Peter L Elkin, Matthew E Levine, Martijn J Schuemie, Hans-Ulrich Prokosch, Fernanda C G Polubriaginof, Martijn J Schuemie, C Maier, Vojtech Huser, Harshana Liyanage, Jeffrey G Klann, Justin Mower, Alex Butler, Anil Pacaci, Christoph Rinner, Y X Sun, Yu Yang, Jenna M Reps, Sigfried Gold, Mary Regina Boland","['Abraham G Hartzema', 'Alex Butler', 'Amy Matcho', 'Anando Sen', 'Anil Pacaci', 'C Maier', 'Casey N Ta', 'Christian Reich', 'Christoph Rinner', 'Dukyong Yoon', 'E A Voss', 'Edeltraut Garbe', 'Erica A Voss', 'F FitzHenry', 'Fernanda C G Polubriaginof', 'Frank J Defalco', 'G Trifiro', 'George Hripcsak', 'Guoqian Jiang', 'Hans-Ulrich Prokosch', 'Harshana Liyanage', 'Hong Sun', 'Hyeoneui Kim', 'Jeffrey G Klann', 'Jenna M Reps', 'Jon D Duke', 'Jonathan C Blaisure', 'Juan M Banda', 'Justin Mower', 'Lian Lian Duan', 'Manfred Hauben', 'Martijn J Schuemie', 'Martin G Seneviratne', 'Mary Regina Boland', 'Maryam Garza', 'Matthew E Levine', 'Matthias Samwald', 'Mohammed Khalilia', 'Na Hong', 'Nir Nissim', 'Omolola I Ogunyemi', 'Patrick B Ryan', 'Paul E Stang', 'Peter L Elkin', 'Peter R Rijnbeek', 'R Harpaz', 'R W White', 'Rae Woong Park', 'Richard A Hansen', 'Richard D Boyce', 'Robert Moskovitch', 'Rohit Vashisht', 'Rosa Gini', 'Rupa Makadia', 'Ryan M Carnahan', 'S T Rosenbloom', 'S Vilar', 'Santiago Vilar', 'Seng Chan You', 'Shreya Chakrabarti', 'Sigfried Gold', 'Susan Gruber', 'Tian Kang', 'Tiffany J Callahan', 'Toan C Ong', 'Vojtech Huser', 'Werner Ceusters', 'Xiaochun Li', 'Xiaofeng Zhou', 'Xin Zhang', 'Y X Sun', 'Yihua Xu', 'Ying Li', 'Yu Yang', 'Yuqi Si', 'Zhaobin Kuang', 'nan']",20,77,"['Martin G, Seneviratne', 'Juan M, Banda', 'James D, Brooks', 'Nigam H, Shah', 'Tina M, Hernandez-Boussard'], ['Rohit, Vashisht', 'Kenneth, Jung', 'Alejandro, Schuler', 'Juan M, Banda', 'Rae Woong, Park', 'Sanghyung, Jin', 'Li, Li', 'Joel T, Dudley', 'Kipp W, Johnson', 'Mark M, Shervey', 'Hua, Xu', 'Yonghui, Wu', 'Karthik, Natrajan', 'George, Hripcsak', 'Peng, Jin', 'Mui, Van Zandt', 'Anthony, Reckard', 'Christian G, Reich', 'James, Weaver', 'Martijn J, Schuemie', 'Patrick B, Ryan', 'Alison, Callahan', 'Nigam H, Shah'], ['Na, Hong', 'Ning, Zhang', 'Huawei, Wu', 'Shanshan, Lu', 'Yue, Yu', 'Li, Hou', 'Yinying, Lu', 'Hongfang, Liu', 'Guoqian, Jiang'], ['Casey N, Ta', 'Michel, Dumontier', 'George, Hripcsak', 'Nicholas P, Tatonetti', 'Chunhua, Weng'], ['Xin, Zhang', 'Li, Wang', 'Shumei, Miao', 'Hua, Xu', 'Yuechuchu, Yin', 'Yueshi, Zhu', 'Zuolei, Dai', 'Tao, Shan', 'Shenqi, Jing', 'Jian, Wang', 'Xiaoliang, Zhang', 'Zhongqiu, Huang', 'Zhongmin, Wang', 'Jianjun, Guo', 'Yun, Liu'], ['George, Hripcsak', 'Matthew E, Levine', 'Ning, Shang', 'Patrick B, Ryan'], ['Peter L, Elkin', 'Sarah, Mullin', 'Sylvester, Sakilay'], ['Matthew E, Levine', 'David J, Albers', 'George, Hripcsak'], ['Martijn J, Schuemie', 'Patrick B, Ryan', 'George, Hripcsak', 'David, Madigan', 'Marc A, Suchard'], ['Hans-Ulrich, Prokosch', 'Till, Acker', 'Johannes, Bernarding', 'Harald, Binder', 'Martin, Boeker', 'Melanie, Boerries', 'Philipp, Daumke', 'Thomas, Ganslandt', 'Jurgen, Hesser', 'Gunther, Honing', 'Michael, Neumaier', 'Kurt, Marquardt', 'Harald, Renz', 'Hermann-Josef, Rothkotter', 'Carmen, Schade-Brittinger', 'Paul, Schmucker', 'Jurgen, Schuttler', 'Martin, Sedlmayr', 'Hubert, Serve', 'Keywan, Sohrabi', 'Holger, Storf'], ['Fernanda C G, Polubriaginof', 'Rami, Vanguri', 'Kayla, Quinnies', 'Gillian M, Belbin', 'Alexandre, Yahi', 'Hojjat, Salmasian', 'Tal, Lorberbaum', 'Victor, Nwankwo', 'Li, Li', 'Mark M, Shervey', 'Patricia, Glowe', 'Iuliana, Ionita-Laza', 'Mary, Simmerling', 'George, Hripcsak', 'Suzanne, Bakken', 'David, Goldstein', 'Krzysztof, Kiryluk', 'Eimear E, Kenny', 'Joel, Dudley', 'David K, Vawdrey', 'Nicholas P, Tatonetti'], ['Martijn J, Schuemie', 'George, Hripcsak', 'Patrick B, Ryan', 'David, Madigan', 'Marc A, Suchard'], ['C, Maier', 'L, Lang', 'H, Storf', 'P, Vormstein', 'R, Bieber', 'J, Bernarding', 'T, Herrmann', 'C, Haverkamp', 'P, Horki', 'J, Laufer', 'F, Berger', 'G, Honing', 'H W, Fritsch', 'J, Schuttler', 'T, Ganslandt', 'H U, Prokosch', 'M, Sedlmayr'], ['Vojtech, Huser', 'Michael G, Kahn', 'Jeffrey S, Brown', 'Ramkiran, Gouripeddi'], ['Harshana, Liyanage', 'Siaw-Teng, Liaw', 'Jitendra, Jonnagaddala', 'William, Hinton', 'Simon, de Lusignan'], ['Jeffrey G, Klann', 'Lori C, Phillips', 'Christopher, Herrick', 'Matthew A H, Joss', 'Kavishwar B, Wagholikar', 'Shawn N, Murphy'], ['Justin, Mower', 'Devika, Subramanian', 'Trevor, Cohen'], ['Alex, Butler', 'Wei, Wei', 'Chi, Yuan', 'Tian, Kang', 'Yuqi, Si', 'Chunhua, Weng'], ['Anil, Pacaci', 'Suat, Gonul', 'A Anil, Sinaci', 'Mustafa, Yuksel', 'Gokce B, Laleci Erturkmen'], ['Christoph, Rinner', 'Deniz, Gezgin', 'Christopher, Wendl', 'Walter, Gall'], ['Y X, Sun', 'Z C, Pei', 'S Y, Zhan'], ['Yu, Yang', 'Xiaofeng, Zhou', 'Shuangqing, Gao', 'Hongbo, Lin', 'Yanming, Xie', 'Yuji, Feng', 'Kui, Huang', 'Siyan, Zhan'], ['Jenna M, Reps', 'Martijn J, Schuemie', 'Marc A, Suchard', 'Patrick B, Ryan', 'Peter R, Rijnbeek'], ['Sigfried, Gold', 'Andrea, Batch', 'Robert, McClure', 'Guoqian, Jiang', 'Hadi, Kharrazi', 'Rishi, Saripalle', 'Vojtech, Huser', 'Chunhua, Weng', 'Nancy, Roderer', 'Ana, Szarfman', 'Niklas, Elmqvist', 'David, Gotz'], ['Mary Regina, Boland', 'Pradipta, Parhi', 'Li, Li', 'Riccardo, Miotto', 'Robert, Carroll', 'Usman, Iqbal', 'Phung-Anh Alex, Nguyen', 'Martijn, Schuemie', 'Seng Chan, You', 'Donahue, Smith', 'Sean, Mooney', 'Patrick, Ryan', 'Yu-Chuan Jack, Li', 'Rae Woong, Park', 'Josh, Denny', 'Joel T, Dudley', 'George, Hripcsak', 'Pierre, Gentine', 'Nicholas P, Tatonetti']","'Martin G Seneviratne', 'Juan M Banda', 'James D Brooks', 'Nigam H Shah', 'Tina M Hernandez-Boussard', 'Rohit Vashisht', 'Kenneth Jung', 'Alejandro Schuler', 'Juan M Banda', 'Rae Woong Park', 'Sanghyung Jin', 'Li Li', 'Joel T Dudley', 'Kipp W Johnson', 'Mark M Shervey', 'Hua Xu', 'Yonghui Wu', 'Karthik Natrajan', 'George Hripcsak', 'Peng Jin', 'Mui Van Zandt', 'Anthony Reckard', 'Christian G Reich', 'James Weaver', 'Martijn J Schuemie', 'Patrick B Ryan', 'Alison Callahan', 'Nigam H Shah', 'Na Hong', 'Ning Zhang', 'Huawei Wu', 'Shanshan Lu', 'Yue Yu', 'Li Hou', 'Yinying Lu', 'Hongfang Liu', 'Guoqian Jiang', 'Casey N Ta', 'Michel Dumontier', 'George Hripcsak', 'Nicholas P Tatonetti', 'Chunhua Weng', 'Xin Zhang', 'Li Wang', 'Shumei Miao', 'Hua Xu', 'Yuechuchu Yin', 'Yueshi Zhu', 'Zuolei Dai', 'Tao Shan', 'Shenqi Jing', 'Jian Wang', 'Xiaoliang Zhang', 'Zhongqiu Huang', 'Zhongmin Wang', 'Jianjun Guo', 'Yun Liu', 'George Hripcsak', 'Matthew E Levine', 'Ning Shang', 'Patrick B Ryan', 'Peter L Elkin', 'Sarah Mullin', 'Sylvester Sakilay', 'Matthew E Levine', 'David J Albers', 'George Hripcsak', 'Martijn J Schuemie', 'Patrick B Ryan', 'George Hripcsak', 'David Madigan', 'Marc A Suchard', 'Hans-Ulrich Prokosch', 'Till Acker', 'Johannes Bernarding', 'Harald Binder', 'Martin Boeker', 'Melanie Boerries', 'Philipp Daumke', 'Thomas Ganslandt', 'Jurgen Hesser', 'Gunther Honing', 'Michael Neumaier', 'Kurt Marquardt', 'Harald Renz', 'Hermann-Josef Rothkotter', 'Carmen Schade-Brittinger', 'Paul Schmucker', 'Jurgen Schuttler', 'Martin Sedlmayr', 'Hubert Serve', 'Keywan Sohrabi', 'Holger Storf', 'Fernanda C G Polubriaginof', 'Rami Vanguri', 'Kayla Quinnies', 'Gillian M Belbin', 'Alexandre Yahi', 'Hojjat Salmasian', 'Tal Lorberbaum', 'Victor Nwankwo', 'Li Li', 'Mark M Shervey', 'Patricia Glowe', 'Iuliana Ionita-Laza', 'Mary Simmerling', 'George Hripcsak', 'Suzanne Bakken', 'David Goldstein', 'Krzysztof Kiryluk', 'Eimear E Kenny', 'Joel Dudley', 'David K Vawdrey', 'Nicholas P Tatonetti', 'Martijn J Schuemie', 'George Hripcsak', 'Patrick B Ryan', 'David Madigan', 'Marc A Suchard', 'C Maier', 'L Lang', 'H Storf', 'P Vormstein', 'R Bieber', 'J Bernarding', 'T Herrmann', 'C Haverkamp', 'P Horki', 'J Laufer', 'F Berger', 'G Honing', 'H W Fritsch', 'J Schuttler', 'T Ganslandt', 'H U Prokosch', 'M Sedlmayr', 'Vojtech Huser', 'Michael G Kahn', 'Jeffrey S Brown', 'Ramkiran Gouripeddi', 'Harshana Liyanage', 'Siaw-Teng Liaw', 'Jitendra Jonnagaddala', 'William Hinton', 'Simon de Lusignan', 'Jeffrey G Klann', 'Lori C Phillips', 'Christopher Herrick', 'Matthew A H Joss', 'Kavishwar B Wagholikar', 'Shawn N Murphy', 'Justin Mower', 'Devika Subramanian', 'Trevor Cohen', 'Alex Butler', 'Wei Wei', 'Chi Yuan', 'Tian Kang', 'Yuqi Si', 'Chunhua Weng', 'Anil Pacaci', 'Suat Gonul', 'A Anil Sinaci', 'Mustafa Yuksel', 'Gokce B Laleci Erturkmen', 'Christoph Rinner', 'Deniz Gezgin', 'Christopher Wendl', 'Walter Gall', 'Y X Sun', 'Z C Pei', 'S Y Zhan', 'Yu Yang', 'Xiaofeng Zhou', 'Shuangqing Gao', 'Hongbo Lin', 'Yanming Xie', 'Yuji Feng', 'Kui Huang', 'Siyan Zhan', 'Jenna M Reps', 'Martijn J Schuemie', 'Marc A Suchard', 'Patrick B Ryan', 'Peter R Rijnbeek', 'Sigfried Gold', 'Andrea Batch', 'Robert McClure', 'Guoqian Jiang', 'Hadi Kharrazi', 'Rishi Saripalle', 'Vojtech Huser', 'Chunhua Weng', 'Nancy Roderer', 'Ana Szarfman', 'Niklas Elmqvist', 'David Gotz', 'Mary Regina Boland', 'Pradipta Parhi', 'Li Li', 'Riccardo Miotto', 'Robert Carroll', 'Usman Iqbal', 'Phung-Anh Alex Nguyen', 'Martijn Schuemie', 'Seng Chan You', 'Donahue Smith', 'Sean Mooney', 'Patrick Ryan', 'Yu-Chuan Jack Li', 'Rae Woong Park', 'Josh Denny', 'Joel T Dudley', 'George Hripcsak', 'Pierre Gentine', 'Nicholas P Tatonetti'","['A Anil Sinaci', 'A Bauer-Mehren', 'Abraham G Hartzema', 'Adler Perotte', 'Ajit Londhe', 'Alan E Bauck', 'Alein T Chun', 'Alejandro Schuler', 'Alessandro Pasqua', 'Alex Butler', 'Alexander M Walker', 'Alexander Rusanov', 'Alexandra Jacunski', 'Alexandre Yahi', 'Alison Callahan', 'Aloka Chakravarty', 'Amelia Henderson', 'Amy Matcho', 'Ana Szarfman', 'Anando Sen', 'Andrea Batch', 'Andrea Donatini', 'Andrew Bate', 'Andrew E Williams', 'Andrew Goldstein', 'Anil Pacaci', 'Anita Walden', 'Anthony Reckard', 'Aviram Weiss', 'Aziz Boxwala', 'B Mosseveld', 'Benjamin Teeter', 'Bethany M Kwan', 'Bing Cai', 'Boris De Vloed', 'Brandon T Suehs', 'Brian C Sauer', 'Bruce M Psaty', 'Bruce N Davidson', 'C Friedman', 'C Haverkamp', 'C Maier', 'Carmelo Montalbano', 'Carmen Schade-Brittinger', 'Carol Friedman', 'Casey N Ta', 'Charles Bailey', 'Charles F 3rd Reynolds', 'Chi Yuan', 'Chris Knoll', 'Chris Uhrich', 'Christian Reich', 'Christoph Rinner', 'Christophe G Lambert', 'Christopher Herrick', 'Christopher Wendl', 'Chuck Wentworth', 'Chunhua Weng', 'Claudio Cricelli', 'D Madigan', 'D Meeker', 'D Weibel', 'Dahye Shin', 'Daniel C Malone', 'Daniel Fife', 'Daniella Meeker', 'David Bertoch', 'David Goldstein', 'David Gotz', 'David J Albers', 'David K Vawdrey', 'David Madigan', 'David Martin', 'David Page', 'David Sontag', 'Deepak K Sharma', 'Deniz Gezgin', 'Devika Subramanian', 'Dirk Colaert', 'Donahue Smith', 'Dong Ki Kim', 'Dong Kyun Park', 'Dukyong Yoon', 'E A Vos', 'E Horvitz', 'Edeltraut Garbe', 'Edoardo Vacchi', 'Eimear E Kenny', 'Elias Brandt', 'Elisa Bianchini', 'Emanuele Carlini', 'Emily Welebob', 'Eric Tchetgen Tchetgen', 'Erica A Voss', 'Eun Kyoung Ahn', 'Eun-Young Jung', 'F Berger', 'F FitzHenry', 'F S Resnic', 'Fernanda Polubriaginof', 'Francesco Innocenti', 'Francesco Lapi', 'Francesco Profili', 'Frank J Defalco', 'G Honing', 'G Hripcsak', 'G Niklas Noren', 'G Trifiro', 'Gayo Diallo', 'George Hripcsak', 'Giampiero Mazzaglia', 'Gianluca Trifiro', 'Gillian M Belbin', 'Gino Picelli', 'Giovanni Mels', 'Giulia Dal Co', 'Giuseppe Roberto', 'Gokce B Laleci Erturkmen', 'Gregory W Hruby', 'Guilherme Del Fiol', 'Gunther Honing', 'Guoqian Jiang', 'H Storf', 'H U Prokosch', 'H W Fritsch', 'Hadi Kharrazi', 'Hans-Ulrich Prokosch', 'Harald Binder', 'Harald Renz', 'Harshana Liyanage', 'Harshvinder Bhullar', 'Hermann-Josef Rothkotter', 'Hojjat Salmasian', 'Hojun Park', 'Holger Storf', 'Hong Sun', 'Hong Xu', 'Hongbo Lin', 'Hongfang Liu', 'Hua Xu', 'Huawei Wu', 'Hubert Serve', 'Huub Straatman', 'Hyeon-Eui Kim', 'Iacopo Cricelli', 'Ian Chi Kei Wong', 'Imho Jang', 'Iris Pigeot', 'Iuliana Ionita-Laza', 'J Bernarding', 'J Bonhoeffer', 'J C Denny', 'J Denton', 'J L Warner', 'J Laufer', 'J Marc Overhage', 'J Schuttler', 'J van der Lei', 'Jaehyeong Cho', 'James D Brooks', 'James J Cimino', 'James Weaver', 'Jeeyae Choi', 'Jeff Brown', 'Jeffrey G Klann', 'Jeffrey K Aronson', 'Jeffrey S Brown', 'Jenna M Reps', 'Jennifer C Nelson', 'Jenny Staab', 'Jessica Tenenbaum', 'Jian Wang', 'Jianjun Guo', 'Jimeng Sun', 'Jimmy Quach', 'Jitendra Jonnagaddala', 'Joel T Dudley', 'Johan van der Lei', 'Johannes Bernarding', 'Jon Duke', 'Jonathan Blaisure', 'Jordan F Karp', 'Jos De Roo', 'Jose Luis Oliveira', 'Joseph D Romano', 'Josh Denny', 'Ju Han Kim', 'Juan Gao', 'Juan M Banda', 'Judith A Racoosin', 'Jurgen Hesser', 'Jurgen Schuttler', 'Justin Mower', 'Kalyani Sonawane', 'Karthik Natrajan', 'Kathrin Blagec', 'Kavishwar B Wagholikar', 'Kayla Quinnies', 'Kenneth Jung', 'Keran Moll', 'Kevin G Moores', 'Keywan Sohrabi', 'Kimberly Westrich', 'Kipp W Johnson', 'Konrad J Karczewski', 'Kristof Depraetere', 'Krzysztof Kiryluk', 'Kui Huang', 'Kurt Marquardt', 'L Lang', 'L Nookala', 'L Ohno-Machado', 'Lars Pedersen', 'Levon Utidjian', 'Li Hou', 'Li Wang', 'Lian Lian Duan', 'Lisa M Schilling', 'Lori C Phillips', 'Lucila Ohno-Machado', 'M E Matheny', 'M J Schuemie', 'M Sedlmayr', 'M Soledad Cepeda', 'Man Young Park', 'Manfred Hauben', 'Marc A Suchard', 'Marc Rosenman', 'Marc Twagirumukiza', 'Margaret K Pasquale', 'Mariadonata Bellentani', 'Marie-Sophie Schwalm', 'Mark Braunstein', 'Mark Khayter', 'Mark Levenson', 'Mark M Shervey', 'Mark Velez', 'Martijn J Schuemie', 'Martin Boeker', 'Martin G Seneviratne', 'Martin Sedlmayr', 'Mary Regina Boland', 'Mary Simmerling', 'Maryam Garza', 'Massimo Coppola', 'Matthew A H Joss', 'Matthew E Levine', 'Matthias Samwald', 'Mei Liu', 'Melanie Boerries', 'Meredith N Zozus', 'Meredith Nahm Zozus', 'Michael E Matheny', 'Michael G Kahn', 'Michael Neumaier', 'Michel Dumontier', 'Miriam C J M Sturkenboom', 'Mitra Rocca', 'Modesta Visca', 'Mohammad Khoshneshin', 'Mohammed Khalilia', 'Mui Van Zandt', 'Mustafa Yuksel', 'Myung Choi', 'N H Shah', 'N P Tatonetti', 'Na Hong', 'Nancy Roderer', 'Naveen Ashish', 'Nicholas P Tatonetti', 'Nicole G Weiskopf', 'Nicole Pratt', 'Niek Klazinga', 'Nigam H Shah', 'Niklas Elmqvist', 'Ning Shang', 'Ning Zhang', 'Nir Nissim', 'Noemie Elhadad', 'Omolola I Ogunyemi', 'P E Stang', 'P Horki', 'P LePendu', 'P M Coloma', 'P R Rijnbeek', 'P Ryan', 'P Vormstein', 'Paolo Francesconi', 'Patricia Glowe', 'Patrick B Ryan', 'Patrick Hosokawa', 'Patrizio Dazzi', 'Paul Avillach', 'Paul E Stang', 'Paul Schmucker', 'Peggy Peissig', 'Peng Jin', 'Peng Zeng', 'Peter L Elkin', 'Peter R Rijnbeek', 'Philip E Empey', 'Philipp Daumke', 'Phung-Anh Alex Nguyen', 'Pierre Gentine', 'Pradipta Parhi', 'Preciosa M Coloma', 'Qianli Ma', 'Qing Liu', 'R Bieber', 'R D Boyce', 'R Harpaz', 'R J Carroll', 'R W White', 'Rae Woong Park', 'Rami Vanguri', 'Ramkiran Gouripeddi', 'Rave Harpaz', 'Riccardo Miotto', 'Richard A Hansen', 'Richard D Boyce', 'Richard Kiefer', 'Richard Maclin', 'Rishi Saripalle', 'Ritu Khare', 'Robert Carroll', 'Robert McClure', 'Robert Moskovitch', 'Robert W Dubois', 'Roberto Berni', 'Robin E Ferner', 'Rohit Vashisht', 'Ron M C Herings', 'Rosa Gini', 'Rupa Makadia', 'Ryan M Carnahan', 'S L Robbins', 'S Romio', 'S T Rosenbloom', 'S Vilar', 'S Y Zhan', 'Sanghyung Jin', 'Santiago Vilar', 'Sarah Mullin', 'Sean Mooney', 'Sebastian Hofer', 'Seena Farzaneh', 'Seid Mussa Ahmed', 'Seng Chan Yo', 'Sengwee Toh', 'Seongwon Lee', 'Shanshan Lu', 'Shaodian Zhang', 'Shawn N Murphy', 'Shenqi Jing', 'Shreya Chakrabarti', 'Shuang Wang', 'Shuangqing Gao', 'Shumei Miao', 'Siaw-Teng Liaw', 'Sigfried Gold', 'Simon de Lusignan', 'Simone Pinheiro', 'Siu Hui', 'Siyan Zhan', 'Sneha Iyengar', 'Soo Yeon Cho', 'Steven M Handler', 'Suat Gonul', 'Subashan Perera', 'Sundaresan Murugesan', 'Sungjae Jung', 'Susan Gruber', 'Susan R Heckbert', 'Suzanne Bakken', 'Sylvester Sakilay', 'T Ganslandt', 'T Herrmann', 'Tal Lorberbaum', 'Tao Shan', 'Thomas Ganslandt', 'Tian Kang', 'Tiffany J Callahan', 'Till Acker', 'Tina M Hernandez-Boussard', 'Toan C Ong', 'Traci Yamashita', 'Trevor Cohen', 'Usman Iqbal', 'Valentina Barletta', 'Victor Nwankwo', 'Vinit P Nair', 'Vitor Santos Costa', 'Vivienne Zhu', 'Vojtech Huser', 'W DuMouchel', 'W Nick Street', 'Walter Cazzola', 'Walter Gall', 'Werner Ceusters', 'William DuMouchel', 'William Hinton', 'Xiaochun Li', 'Xiaofeng Zhou', 'Xiaoliang Zhang', 'Xin Zhang', 'Y X Sun', 'Yanming Xie', 'Yeonsoo Hwang', 'Yihua Xu', 'Ying Li', 'Ying Wei', 'Yinying Lu', 'Yola Moride', 'Yonghui Wu', 'Yoni Halpern', 'Youlan Tang', 'Yu Yang', 'Yu-Chuan Li', 'Yue Yu', 'Yuechuchu Yin', 'Yueshi Zhu', 'Yuji Feng', 'Yun Liu', 'Yuqi Si', 'Yuriy Khoma', 'Yuval Elovici', 'Yuval Shahar', 'Z C Pei', 'Zach Shahn', 'Zachary Shahn', 'Zhaobin Kuang', 'Zhongmin Wang', 'Zhongqiu Huang', 'Zuolei Dai', 'hommeaux Eri']",149,435
7,2019,"Luke V Rasmussen, Victoria L Bartlett, Stephane M Meystre, Rimma Belenkaya, Guoqian Jiang, Daniel M Lima, Jenna M Reps, Joel N Swerdel, George Hripcsak, Juan M Banda, Jeremy L Warner, James R Rogers, Jenna M Reps, John Weeks, Yue Yu, Manlik Kwong, Julian Gruendner, Kristine E Lynch, Benjamin S Glicksberg, Julian Gruendner, Guan N Guo, Ning Shang, Andrea Haberson, Seo Jeong Shin, Benjamin Viernes, Christel Daniel, Benjamin S Glicksberg, Himanshu Sharma, Andrea Haberson, Seo Jeong Shin, Jeffrey G Klann, Chi Yuan, Minh Pham, Martijn J Schuemie, Martijn J Schuemie, Lu Wang, Marc A Suchard, Casey N Ta, Patrick Wu","['Abraham G Hartzema', 'Alex Butler', 'Amy Matcho', 'Anando Sen', 'Andrea Haberson', 'Anil Pacaci', 'Benjamin S Glicksberg', 'Benjamin Viernes', 'C Maier', 'Casey N Ta', 'Chi Yuan', 'Christel Daniel', 'Christian Reich', 'Christoph Rinner', 'Daniel M Lima', 'Dukyong Yoon', 'E A Voss', 'Edeltraut Garbe', 'Erica A Voss', 'F FitzHenry', 'Fernanda C G Polubriaginof', 'Frank J Defalco', 'G Trifiro', 'George Hripcsak', 'Guan N Guo', 'Guoqian Jiang', 'Hans-Ulrich Prokosch', 'Harshana Liyanage', 'Himanshu Sharma', 'Hong Sun', 'Hyeoneui Kim', 'James R Rogers', 'Jeffrey G Klann', 'Jenna M Reps', 'Jeremy L Warner', 'Joel N Swerdel', 'John Weeks', 'Jon D Duke', 'Jonathan C Blaisure', 'Juan M Banda', 'Julian Gruendner', 'Justin Mower', 'Kristine E Lynch', 'Lian Lian Duan', 'Lu Wang', 'Luke V Rasmussen', 'Manfred Hauben', 'Manlik Kwong', 'Marc A Suchard', 'Martijn J Schuemie', 'Martin G Seneviratne', 'Mary Regina Boland', 'Maryam Garza', 'Matthew E Levine', 'Matthias Samwald', 'Minh Pham', 'Mohammed Khalilia', 'Na Hong', 'Ning Shang', 'Nir Nissim', 'Omolola I Ogunyemi', 'Patrick B Ryan', 'Paul E Stang', 'Peter L Elkin', 'Peter R Rijnbeek', 'R Harpaz', 'R W White', 'Rae Woong Park', 'Richard A Hansen', 'Richard D Boyce', 'Rimma Belenkaya', 'Robert Moskovitch', 'Rohit Vashisht', 'Rosa Gini', 'Rupa Makadia', 'Ryan M Carnahan', 'S T Rosenbloom', 'S Vilar', 'Santiago Vilar', 'Seng Chan You', 'Seo Jeong Shin', 'Shreya Chakrabarti', 'Sigfried Gold', 'Stephane M Meystre', 'Susan Gruber', 'Tian Kang', 'Tiffany J Callahan', 'Toan C Ong', 'Victoria L Bartlett', 'Vojtech Huser', 'Werner Ceusters', 'Xiaochun Li', 'Xiaofeng Zhou', 'Xin Zhang', 'Y X Sun', 'Yihua Xu', 'Ying Li', 'Yu Yang', 'Yue Yu', 'Yuqi Si', 'Zhaobin Kuang', 'nan']",25,102,"['Luke V, Rasmussen', 'Pascal S, Brandt', 'Guoqian, Jiang', 'Richard C, Kiefer', 'Jennifer A, Pacheco', 'Prakash, Adekkanattu', 'Jessica S, Ancker', 'Fei, Wang', 'Zhenxing, Xu', 'Jyotishman, Pathak', 'Yuan, Luo'], ['Victoria L, Bartlett', 'Sanket S, Dhruva', 'Nilay D, Shah', 'Patrick, Ryan', 'Joseph S, Ross'], ['Stephane M, Meystre', 'Paul M, Heider', 'Youngjun, Kim', 'Daniel B, Aruch', 'Carolyn D, Britten'], ['Rimma, Belenkaya', 'Michael, Gurley', 'Dmitry, Dymshyts', 'Sonia, Araujo', 'Andrew, Williams', 'RuiJun, Chen', 'Christian, Reich'], ['Guoqian, Jiang', 'Yue, Yu', 'Paul R, Kingsbury', 'Nilay, Shah'], ['Daniel M, Lima', 'Jose F, Rodrigues-Jr', 'Agma J M, Traina', 'Fabio A, Pires', 'Marco A, Gutierrez'], ['Jenna M, Reps', 'Peter R, Rijnbeek', 'Patrick B, Ryan'], ['Joel N, Swerdel', 'George, Hripcsak', 'Patrick B, Ryan'], ['George, Hripcsak', 'Ning, Shang', 'Peggy L, Peissig', 'Luke V, Rasmussen', 'Cong, Liu', 'Barbara, Benoit', 'Robert J, Carroll', 'David S, Carrell', 'Joshua C, Denny', 'Ozan, Dikilitas', 'Vivian S, Gainer', 'Kayla Marie, Howell', 'Jeffrey G, Klann', 'Iftikhar J, Kullo', 'Todd, Lingren', 'Frank D, Mentch', 'Shawn N, Murphy', 'Karthik, Natarajan', 'Jennifer A, Pacheco', 'Wei-Qi, Wei', 'Ken, Wiley', 'Chunhua, Weng'], ['Juan M, Banda'], ['Jeremy L, Warner', 'Dmitry, Dymshyts', 'Christian G, Reich', 'Michael J, Gurley', 'Harry, Hochheiser', 'Zachary H, Moldwin', 'Rimma, Belenkaya', 'Andrew E, Williams', 'Peter C, Yang'], ['James R, Rogers', 'Tiffany J, Callahan', 'Tian, Kang', 'Alan, Bauck', 'Ritu, Khare', 'Jeffrey S, Brown', 'Michael G, Kahn', 'Chunhua, Weng'], ['Jenna M, Reps', 'Peter R, Rijnbeek', 'Patrick B, Ryan'], ['John, Weeks', 'Roy, Pardee'], ['Yue, Yu', 'Kathryn J, Ruddy', 'Na, Hong', 'Shintaro, Tsuji', 'Andrew, Wen', 'Nilay D, Shah', 'Guoqian, Jiang'], ['Manlik, Kwong', 'Heather L, Gardner', 'Neil, Dieterle', 'Virginia, Rentko'], ['Julian, Gruendner', 'Thorsten, Schwachhofer', 'Phillip, Sippl', 'Nicolas, Wolf', 'Marcel, Erpenbeck', 'Christian, Gulden', 'Lorenz A, Kapsner', 'Jakob, Zierk', 'Sebastian, Mate', 'Michael, Sturzl', 'Roland, Croner', 'Hans-Ulrich, Prokosch', 'Dennis, Toddenroth'], ['Kristine E, Lynch', 'Stephen A, Deppen', 'Scott L, DuVall', 'Benjamin, Viernes', 'Aize, Cao', 'Daniel, Park', 'Elizabeth, Hanchrow', 'Kushan, Hewa', 'Peter, Greaves', 'Michael E, Matheny'], ['Benjamin S, Glicksberg', 'Boris, Oskotsky', 'Nicholas, Giangreco', 'Phyllis M, Thangaraj', 'Vivek, Rudrapatna', 'Debajyoti, Datta', 'Remi, Frazier', 'Nelson, Lee', 'Rick, Larsen', 'Nicholas P, Tatonetti', 'Atul J, Butte'], ['Julian, Gruendner', 'Thorsten, Schwachhofer', 'Phillip, Sippl', 'Nicolas, Wolf', 'Marcel, Erpenbeck', 'Christian, Gulden', 'Lorenz A, Kapsner', 'Jakob, Zierk', 'Sebastian, Mate', 'Michael, Sturzl', 'Roland, Croner', 'Hans-Ulrich, Prokosch', 'Dennis, Toddenroth'], ['Guan N, Guo', 'Jitendra, Jonnagaddala', 'Sanjay, Farshid', 'Vojtech, Huser', 'Christian, Reich', 'Siaw-Teng, Liaw'], ['Ning, Shang', 'Cong, Liu', 'Luke V, Rasmussen', 'Casey N, Ta', 'Robert J, Caroll', 'Barbara, Benoit', 'Todd, Lingren', 'Ozan, Dikilitas', 'Frank D, Mentch', 'David S, Carrell', 'Wei-Qi, Wei', 'Yuan, Luo', 'Vivian S, Gainer', 'Iftikhar J, Kullo', 'Jennifer A, Pacheco', 'Hakon, Hakonarson', 'Theresa L, Walunas', 'Joshua C, Denny', 'Ken, Wiley', 'Shawn N, Murphy', 'George, Hripcsak', 'Chunhua, Weng'], ['Andrea, Haberson', 'Christoph, Rinner', 'Alexander, Schoberl', 'Walter, Gall'], ['Seo Jeong, Shin', 'Seng Chan, You', 'Jin, Roh', 'Yu Rang, Park', 'Rae Woong, Park'], ['Benjamin, Viernes', 'Kristine E, Lynch', 'Brett, South', 'Gregorio, Coronado', 'Scott L, DuVall'], ['Christel, Daniel', 'Dipak, Kalra'], ['Benjamin S, Glicksberg', 'Boris, Oskotsky', 'Phyllis M, Thangaraj', 'Nicholas, Giangreco', 'Marcus A, Badgeley', 'Kipp W, Johnson', 'Debajyoti, Datta', 'Vivek A, Rudrapatna', 'Nadav, Rappoport', 'Mark M, Shervey', 'Riccardo, Miotto', 'Theodore C, Goldstein', 'Eugenia, Rutenberg', 'Remi, Frazier', 'Nelson, Lee', 'Sharat, Israni', 'Rick, Larsen', 'Bethany, Percha', 'Li, Li', 'Joel T, Dudley', 'Nicholas P, Tatonetti', 'Atul J, Butte'], ['Himanshu, Sharma', 'Chengsheng, Mao', 'Yizhen, Zhang', 'Haleh, Vatani', 'Liang, Yao', 'Yizhen, Zhong', 'Luke, Rasmussen', 'Guoqian, Jiang', 'Jyotishman, Pathak', 'Yuan, Luo'], ['Andrea, Haberson', 'Christoph, Rinner', 'Walter, Gall'], ['Seo Jeong, Shin', 'Seng Chan, You', 'Yu Rang, Park', 'Jin, Roh', 'Jang-Hee, Kim', 'Seokjin, Haam', 'Christian G, Reich', 'Clair, Blacketer', 'Dae-Soon, Son', 'Seungbin, Oh', 'Rae Woong, Park'], ['Jeffrey G, Klann', 'Matthew A H, Joss', 'Kevin, Embree', 'Shawn N, Murphy'], ['Chi, Yuan', 'Patrick B, Ryan', 'Casey, Ta', 'Yixuan, Guo', 'Ziran, Li', 'Jill, Hardin', 'Rupa, Makadia', 'Peng, Jin', 'Ning, Shang', 'Tian, Kang', 'Chunhua, Weng'], ['Minh, Pham', 'Feng, Cheng', 'Kandethody, Ramachandran'], ['Martijn J, Schuemie', 'David, Madigan', 'Patrick B, Ryan', 'Christian, Reich', 'Marc A, Suchard', 'Jesse A, Berlin', 'George, Hripcsak'], ['Martijn J, Schuemie', 'Patrick B, Ryan', 'Kenneth K C, Man', 'Ian C K, Wong', 'Marc A, Suchard', 'George, Hripcsak'], ['Lu, Wang', 'Erica A, Voss', 'James, Weaver', 'Laura, Hester', 'Zhong, Yuan', 'Frank, DeFalco', 'Martijn J, Schuemie', 'Patrick B, Ryan', 'Don, Sun', 'Amy, Freedman', 'Maria, Alba', 'Joan, Lind', 'Gary, Meininger', 'Jesse A, Berlin', 'Norman, Rosenthal'], ['Marc A, Suchard', 'Martijn J, Schuemie', 'Harlan M, Krumholz', 'Seng Chan, You', 'RuiJun, Chen', 'Nicole, Pratt', 'Christian G, Reich', 'Jon, Duke', 'David, Madigan', 'George, Hripcsak', 'Patrick B, Ryan'], ['Casey N, Ta', 'Chunhua, Weng'], ['Patrick, Wu', 'Aliya, Gifford', 'Xiangrui, Meng', 'Xue, Li', 'Harry, Campbell', 'Tim, Varley', 'Juan, Zhao', 'Robert, Carroll', 'Lisa, Bastarache', 'Joshua C, Denny', 'Evropi, Theodoratou', 'Wei-Qi, Wei']","'Luke V Rasmussen', 'Pascal S Brandt', 'Guoqian Jiang', 'Richard C Kiefer', 'Jennifer A Pacheco', 'Prakash Adekkanattu', 'Jessica S Ancker', 'Fei Wang', 'Zhenxing Xu', 'Jyotishman Pathak', 'Yuan Luo', 'Victoria L Bartlett', 'Sanket S Dhruva', 'Nilay D Shah', 'Patrick Ryan', 'Joseph S Ross', 'Stephane M Meystre', 'Paul M Heider', 'Youngjun Kim', 'Daniel B Aruch', 'Carolyn D Britten', 'Rimma Belenkaya', 'Michael Gurley', 'Dmitry Dymshyts', 'Sonia Araujo', 'Andrew Williams', 'RuiJun Chen', 'Christian Reich', 'Guoqian Jiang', 'Yue Yu', 'Paul R Kingsbury', 'Nilay Shah', 'Daniel M Lima', 'Jose F Rodrigues-Jr', 'Agma J M Traina', 'Fabio A Pires', 'Marco A Gutierrez', 'Jenna M Reps', 'Peter R Rijnbeek', 'Patrick B Ryan', 'Joel N Swerdel', 'George Hripcsak', 'Patrick B Ryan', 'George Hripcsak', 'Ning Shang', 'Peggy L Peissig', 'Luke V Rasmussen', 'Cong Liu', 'Barbara Benoit', 'Robert J Carroll', 'David S Carrell', 'Joshua C Denny', 'Ozan Dikilitas', 'Vivian S Gainer', 'Kayla Marie Howell', 'Jeffrey G Klann', 'Iftikhar J Kullo', 'Todd Lingren', 'Frank D Mentch', 'Shawn N Murphy', 'Karthik Natarajan', 'Jennifer A Pacheco', 'Wei-Qi Wei', 'Ken Wiley', 'Chunhua Weng', 'Juan M Banda', 'Jeremy L Warner', 'Dmitry Dymshyts', 'Christian G Reich', 'Michael J Gurley', 'Harry Hochheiser', 'Zachary H Moldwin', 'Rimma Belenkaya', 'Andrew E Williams', 'Peter C Yang', 'James R Rogers', 'Tiffany J Callahan', 'Tian Kang', 'Alan Bauck', 'Ritu Khare', 'Jeffrey S Brown', 'Michael G Kahn', 'Chunhua Weng', 'Jenna M Reps', 'Peter R Rijnbeek', 'Patrick B Ryan', 'John Weeks', 'Roy Pardee', 'Yue Yu', 'Kathryn J Ruddy', 'Na Hong', 'Shintaro Tsuji', 'Andrew Wen', 'Nilay D Shah', 'Guoqian Jiang', 'Manlik Kwong', 'Heather L Gardner', 'Neil Dieterle', 'Virginia Rentko', 'Julian Gruendner', 'Thorsten Schwachhofer', 'Phillip Sippl', 'Nicolas Wolf', 'Marcel Erpenbeck', 'Christian Gulden', 'Lorenz A Kapsner', 'Jakob Zierk', 'Sebastian Mate', 'Michael Sturzl', 'Roland Croner', 'Hans-Ulrich Prokosch', 'Dennis Toddenroth', 'Kristine E Lynch', 'Stephen A Deppen', 'Scott L DuVall', 'Benjamin Viernes', 'Aize Cao', 'Daniel Park', 'Elizabeth Hanchrow', 'Kushan Hewa', 'Peter Greaves', 'Michael E Matheny', 'Benjamin S Glicksberg', 'Boris Oskotsky', 'Nicholas Giangreco', 'Phyllis M Thangaraj', 'Vivek Rudrapatna', 'Debajyoti Datta', 'Remi Frazier', 'Nelson Lee', 'Rick Larsen', 'Nicholas P Tatonetti', 'Atul J Butte', 'Julian Gruendner', 'Thorsten Schwachhofer', 'Phillip Sippl', 'Nicolas Wolf', 'Marcel Erpenbeck', 'Christian Gulden', 'Lorenz A Kapsner', 'Jakob Zierk', 'Sebastian Mate', 'Michael Sturzl', 'Roland Croner', 'Hans-Ulrich Prokosch', 'Dennis Toddenroth', 'Guan N Guo', 'Jitendra Jonnagaddala', 'Sanjay Farshid', 'Vojtech Huser', 'Christian Reich', 'Siaw-Teng Liaw', 'Ning Shang', 'Cong Liu', 'Luke V Rasmussen', 'Casey N Ta', 'Robert J Caroll', 'Barbara Benoit', 'Todd Lingren', 'Ozan Dikilitas', 'Frank D Mentch', 'David S Carrell', 'Wei-Qi Wei', 'Yuan Luo', 'Vivian S Gainer', 'Iftikhar J Kullo', 'Jennifer A Pacheco', 'Hakon Hakonarson', 'Theresa L Walunas', 'Joshua C Denny', 'Ken Wiley', 'Shawn N Murphy', 'George Hripcsak', 'Chunhua Weng', 'Andrea Haberson', 'Christoph Rinner', 'Alexander Schoberl', 'Walter Gall', 'Seo Jeong Shin', 'Seng Chan You', 'Jin Roh', 'Yu Rang Park', 'Rae Woong Park', 'Benjamin Viernes', 'Kristine E Lynch', 'Brett South', 'Gregorio Coronado', 'Scott L DuVall', 'Christel Daniel', 'Dipak Kalra', 'Benjamin S Glicksberg', 'Boris Oskotsky', 'Phyllis M Thangaraj', 'Nicholas Giangreco', 'Marcus A Badgeley', 'Kipp W Johnson', 'Debajyoti Datta', 'Vivek A Rudrapatna', 'Nadav Rappoport', 'Mark M Shervey', 'Riccardo Miotto', 'Theodore C Goldstein', 'Eugenia Rutenberg', 'Remi Frazier', 'Nelson Lee', 'Sharat Israni', 'Rick Larsen', 'Bethany Percha', 'Li Li', 'Joel T Dudley', 'Nicholas P Tatonetti', 'Atul J Butte', 'Himanshu Sharma', 'Chengsheng Mao', 'Yizhen Zhang', 'Haleh Vatani', 'Liang Yao', 'Yizhen Zhong', 'Luke Rasmussen', 'Guoqian Jiang', 'Jyotishman Pathak', 'Yuan Luo', 'Andrea Haberson', 'Christoph Rinner', 'Walter Gall', 'Seo Jeong Shin', 'Seng Chan You', 'Yu Rang Park', 'Jin Roh', 'Jang-Hee Kim', 'Seokjin Haam', 'Christian G Reich', 'Clair Blacketer', 'Dae-Soon Son', 'Seungbin Oh', 'Rae Woong Park', 'Jeffrey G Klann', 'Matthew A H Joss', 'Kevin Embree', 'Shawn N Murphy', 'Chi Yuan', 'Patrick B Ryan', 'Casey Ta', 'Yixuan Guo', 'Ziran Li', 'Jill Hardin', 'Rupa Makadia', 'Peng Jin', 'Ning Shang', 'Tian Kang', 'Chunhua Weng', 'Minh Pham', 'Feng Cheng', 'Kandethody Ramachandran', 'Martijn J Schuemie', 'David Madigan', 'Patrick B Ryan', 'Christian Reich', 'Marc A Suchard', 'Jesse A Berlin', 'George Hripcsak', 'Martijn J Schuemie', 'Patrick B Ryan', 'Kenneth K C Man', 'Ian C K Wong', 'Marc A Suchard', 'George Hripcsak', 'Lu Wang', 'Erica A Voss', 'James Weaver', 'Laura Hester', 'Zhong Yuan', 'Frank DeFalco', 'Martijn J Schuemie', 'Patrick B Ryan', 'Don Sun', 'Amy Freedman', 'Maria Alba', 'Joan Lind', 'Gary Meininger', 'Jesse A Berlin', 'Norman Rosenthal', 'Marc A Suchard', 'Martijn J Schuemie', 'Harlan M Krumholz', 'Seng Chan You', 'RuiJun Chen', 'Nicole Pratt', 'Christian G Reich', 'Jon Duke', 'David Madigan', 'George Hripcsak', 'Patrick B Ryan', 'Casey N Ta', 'Chunhua Weng', 'Patrick Wu', 'Aliya Gifford', 'Xiangrui Meng', 'Xue Li', 'Harry Campbell', 'Tim Varley', 'Juan Zhao', 'Robert Carroll', 'Lisa Bastarache', 'Joshua C Denny', 'Evropi Theodoratou', 'Wei-Qi Wei'","['A Anil Sinaci', 'A Bauer-Mehren', 'Abraham G Hartzema', 'Adler Perotte', 'Agma J M Traina', 'Aize Cao', 'Ajit Londhe', 'Alan E Bauck', 'Alein T Chun', 'Alejandro Schuler', 'Alessandro Pasqua', 'Alex Butler', 'Alexander M Walker', 'Alexander Rusanov', 'Alexander Schoberl', 'Alexandra Jacunski', 'Alexandre Yahi', 'Alison Callahan', 'Aliya Gifford', 'Aloka Chakravarty', 'Amelia Henderson', 'Amy Freedman', 'Amy Matcho', 'Ana Szarfman', 'Anando Sen', 'Andrea Batch', 'Andrea Donatini', 'Andrea Haberson', 'Andrew Bate', 'Andrew E Williams', 'Andrew Goldstein', 'Andrew Wen', 'Anil Pacaci', 'Anita Walden', 'Anthony Reckard', 'Atul J Butte', 'Aviram Weiss', 'Aziz Boxwala', 'B Mosseveld', 'Barbara Benoit', 'Benjamin S Glicksberg', 'Benjamin Teeter', 'Benjamin Viernes', 'Bethany M Kwan', 'Bethany Percha', 'Bing Cai', 'Boris De Vloed', 'Boris Oskotsky', 'Brandon T Suehs', 'Brett South', 'Brian C Sauer', 'Bruce M Psaty', 'Bruce N Davidson', 'C Friedman', 'C Haverkamp', 'C Maier', 'Carmelo Montalbano', 'Carmen Schade-Brittinger', 'Carol Friedman', 'Carolyn D Britten', 'Casey N Ta', 'Charles Bailey', 'Charles F 3rd Reynolds', 'Chengsheng Mao', 'Chi Yuan', 'Chris Knoll', 'Chris Uhrich', 'Christel Daniel', 'Christian Gulden', 'Christian Reich', 'Christoph Rinner', 'Christophe G Lambert', 'Christopher Herrick', 'Christopher Wendl', 'Chuck Wentworth', 'Chunhua Weng', 'Clair Blacketer', 'Claudio Cricelli', 'Cong Liu', 'D Madigan', 'D Meeker', 'D Weibel', 'Dae-Soon Son', 'Dahye Shin', 'Daniel B Aruch', 'Daniel C Malone', 'Daniel Fife', 'Daniel M Lima', 'Daniel Park', 'Daniella Meeker', 'David Bertoch', 'David Goldstein', 'David Gotz', 'David J Albers', 'David K Vawdrey', 'David Madigan', 'David Martin', 'David Page', 'David S Carrell', 'David Sontag', 'Debajyoti Datta', 'Deepak K Sharma', 'Deniz Gezgin', 'Dennis Toddenroth', 'Devika Subramanian', 'Dipak Kalra', 'Dirk Colaert', 'Dmitry Dymshyts', 'Don Sun', 'Donahue Smith', 'Dong Ki Kim', 'Dong Kyun Park', 'Dukyong Yoon', 'E A Vos', 'E Horvitz', 'Edeltraut Garbe', 'Edoardo Vacchi', 'Eimear E Kenny', 'Elias Brandt', 'Elisa Bianchini', 'Elizabeth Hanchrow', 'Emanuele Carlini', 'Emily Welebob', 'Eric Tchetgen Tchetgen', 'Erica A Voss', 'Eugenia Rutenberg', 'Eun Kyoung Ahn', 'Eun-Young Jung', 'Evropi Theodoratou', 'F Berger', 'F FitzHenry', 'F S Resnic', 'Fabio A Pires', 'Fei Wang', 'Feng Cheng', 'Fernanda Polubriaginof', 'Francesco Innocenti', 'Francesco Lapi', 'Francesco Profili', 'Frank D Mentch', 'Frank J Defalco', 'G Honing', 'G Hripcsak', 'G Niklas Noren', 'G Trifiro', 'Gary Meininger', 'Gayo Diallo', 'George Hripcsak', 'Giampiero Mazzaglia', 'Gianluca Trifiro', 'Gillian M Belbin', 'Gino Picelli', 'Giovanni Mels', 'Giulia Dal Co', 'Giuseppe Roberto', 'Gokce B Laleci Erturkmen', 'Gregorio Coronado', 'Gregory W Hruby', 'Guan N Guo', 'Guilherme Del Fiol', 'Gunther Honing', 'Guoqian Jiang', 'H Storf', 'H U Prokosch', 'H W Fritsch', 'Hadi Kharrazi', 'Hakon Hakonarson', 'Haleh Vatani', 'Hans-Ulrich Prokosch', 'Harald Binder', 'Harald Renz', 'Harlan M Krumholz', 'Harry Campbell', 'Harry Hochheiser', 'Harshana Liyanage', 'Harshvinder Bhullar', 'Heather L Gardner', 'Hermann-Josef Rothkotter', 'Himanshu Sharma', 'Hojjat Salmasian', 'Hojun Park', 'Holger Storf', 'Hong Sun', 'Hong Xu', 'Hongbo Lin', 'Hongfang Liu', 'Hua Xu', 'Huawei Wu', 'Hubert Serve', 'Huub Straatman', 'Hyeon-Eui Kim', 'Iacopo Cricelli', 'Ian C K Wong', 'Ian Chi Kei Wong', 'Iftikhar J Kullo', 'Imho Jang', 'Iris Pigeot', 'Iuliana Ionita-Laza', 'J Bernarding', 'J Bonhoeffer', 'J C Denny', 'J Denton', 'J L Warner', 'J Laufer', 'J Marc Overhage', 'J Schuttler', 'J van der Lei', 'Jaehyeong Cho', 'Jakob Zierk', 'James D Brooks', 'James J Cimino', 'James R Rogers', 'James Weaver', 'Jang-Hee Kim', 'Jeeyae Choi', 'Jeff Brown', 'Jeffrey G Klann', 'Jeffrey K Aronson', 'Jeffrey S Brown', 'Jenna M Reps', 'Jennifer A Pacheco', 'Jennifer C Nelson', 'Jenny Staab', 'Jeremy L Warner', 'Jesse A Berlin', 'Jessica S Ancker', 'Jessica Tenenbaum', 'Jian Wang', 'Jianjun Guo', 'Jill Hardin', 'Jimeng Sun', 'Jimmy Quach', 'Jin Roh', 'Jitendra Jonnagaddala', 'Joan Lind', 'Joel N Swerdel', 'Joel T Dudley', 'Johan van der Lei', 'Johannes Bernarding', 'John Weeks', 'Jon Duke', 'Jonathan Blaisure', 'Jordan F Karp', 'Jos De Roo', 'Jose F Rodrigues-Jr', 'Jose Luis Oliveira', 'Joseph D Romano', 'Joseph S Ross', 'Josh Denny', 'Joshua C Denny', 'Ju Han Kim', 'Juan Gao', 'Juan M Banda', 'Juan Zhao', 'Judith A Racoosin', 'Julian Gruendner', 'Jurgen Hesser', 'Jurgen Schuttler', 'Justin Mower', 'Jyotishman Pathak', 'Kalyani Sonawane', 'Kandethody Ramachandran', 'Karthik Natrajan', 'Kathrin Blagec', 'Kathryn J Ruddy', 'Kavishwar B Wagholikar', 'Kayla Marie Howell', 'Kayla Quinnies', 'Ken Wiley', 'Kenneth Jung', 'Kenneth K C Man', 'Keran Moll', 'Kevin Embree', 'Kevin G Moores', 'Keywan Sohrabi', 'Kimberly Westrich', 'Kipp W Johnson', 'Konrad J Karczewski', 'Kristine E Lynch', 'Kristof Depraetere', 'Krzysztof Kiryluk', 'Kui Huang', 'Kurt Marquardt', 'Kushan Hewa', 'L Lang', 'L Nookala', 'L Ohno-Machado', 'Lars Pedersen', 'Laura Hester', 'Levon Utidjian', 'Li Hou', 'Li Wang', 'Lian Lian Duan', 'Liang Yao', 'Lisa Bastarache', 'Lisa M Schilling', 'Lorenz A Kapsner', 'Lori C Phillips', 'Lu Wang', 'Lucila Ohno-Machado', 'Luke V Rasmussen', 'M E Matheny', 'M J Schuemie', 'M Sedlmayr', 'M Soledad Cepeda', 'Man Young Park', 'Manfred Hauben', 'Manlik Kwong', 'Marc A Suchard', 'Marc Rosenman', 'Marc Twagirumukiza', 'Marcel Erpenbeck', 'Marco A Gutierrez', 'Marcus A Badgeley', 'Margaret K Pasquale', 'Maria Alba', 'Mariadonata Bellentani', 'Marie-Sophie Schwalm', 'Mark Braunstein', 'Mark Khayter', 'Mark Levenson', 'Mark M Shervey', 'Mark Velez', 'Martijn J Schuemie', 'Martin Boeker', 'Martin G Seneviratne', 'Martin Sedlmayr', 'Mary Regina Boland', 'Mary Simmerling', 'Maryam Garza', 'Massimo Coppola', 'Matthew A H Joss', 'Matthew E Levine', 'Matthias Samwald', 'Mei Liu', 'Melanie Boerries', 'Meredith N Zozus', 'Meredith Nahm Zozus', 'Michael E Matheny', 'Michael G Kahn', 'Michael Gurley', 'Michael Neumaier', 'Michael Sturzl', 'Michel Dumontier', 'Minh Pham', 'Miriam C J M Sturkenboom', 'Mitra Rocca', 'Modesta Visca', 'Mohammad Khoshneshin', 'Mohammed Khalilia', 'Mui Van Zandt', 'Mustafa Yuksel', 'Myung Choi', 'N H Shah', 'N P Tatonetti', 'Na Hong', 'Nadav Rappoport', 'Nancy Roderer', 'Naveen Ashish', 'Neil Dieterle', 'Nelson Lee', 'Nicholas Giangreco', 'Nicholas P Tatonetti', 'Nicolas Wolf', 'Nicole G Weiskopf', 'Nicole Pratt', 'Niek Klazinga', 'Nigam H Shah', 'Niklas Elmqvist', 'Nilay D Shah', 'Ning Shang', 'Ning Zhang', 'Nir Nissim', 'Noemie Elhadad', 'Norman Rosenthal', 'Omolola I Ogunyemi', 'Ozan Dikilitas', 'P E Stang', 'P Horki', 'P LePendu', 'P M Coloma', 'P R Rijnbeek', 'P Ryan', 'P Vormstein', 'Paolo Francesconi', 'Pascal S Brandt', 'Patricia Glowe', 'Patrick B Ryan', 'Patrick Hosokawa', 'Patrick Wu', 'Patrizio Dazzi', 'Paul Avillach', 'Paul E Stang', 'Paul M Heider', 'Paul R Kingsbury', 'Paul Schmucker', 'Peggy Peissig', 'Peng Jin', 'Peng Zeng', 'Peter C Yang', 'Peter Greaves', 'Peter L Elkin', 'Peter R Rijnbeek', 'Philip E Empey', 'Philipp Daumke', 'Phillip Sippl', 'Phung-Anh Alex Nguyen', 'Phyllis M Thangaraj', 'Pierre Gentine', 'Pradipta Parhi', 'Prakash Adekkanattu', 'Preciosa M Coloma', 'Qianli Ma', 'Qing Liu', 'R Bieber', 'R D Boyce', 'R Harpaz', 'R J Carroll', 'R W White', 'Rae Woong Park', 'Rami Vanguri', 'Ramkiran Gouripeddi', 'Rave Harpaz', 'Remi Frazier', 'Riccardo Miotto', 'Richard A Hansen', 'Richard D Boyce', 'Richard Kiefer', 'Richard Maclin', 'Rick Larsen', 'Rimma Belenkaya', 'Rishi Saripalle', 'Ritu Khare', 'Robert Carroll', 'Robert J Caroll', 'Robert McClure', 'Robert Moskovitch', 'Robert W Dubois', 'Roberto Berni', 'Robin E Ferner', 'Rohit Vashisht', 'Roland Croner', 'Ron M C Herings', 'Rosa Gini', 'Roy Pardee', 'RuiJun Chen', 'Rupa Makadia', 'Ryan M Carnahan', 'S L Robbins', 'S Romio', 'S T Rosenbloom', 'S Vilar', 'S Y Zhan', 'Sanghyung Jin', 'Sanjay Farshid', 'Sanket S Dhruva', 'Santiago Vilar', 'Sarah Mullin', 'Scott L DuVall', 'Sean Mooney', 'Sebastian Hofer', 'Sebastian Mate', 'Seena Farzaneh', 'Seid Mussa Ahmed', 'Seng Chan Yo', 'Sengwee Toh', 'Seo Jeong Shin', 'Seokjin Haam', 'Seongwon Lee', 'Seungbin Oh', 'Shanshan Lu', 'Shaodian Zhang', 'Sharat Israni', 'Shawn N Murphy', 'Shenqi Jing', 'Shintaro Tsuji', 'Shreya Chakrabarti', 'Shuang Wang', 'Shuangqing Gao', 'Shumei Miao', 'Siaw-Teng Liaw', 'Sigfried Gold', 'Simon de Lusignan', 'Simone Pinheiro', 'Siu Hui', 'Siyan Zhan', 'Sneha Iyengar', 'Sonia Araujo', 'Soo Yeon Cho', 'Stephane M Meystre', 'Stephen A Deppen', 'Steven M Handler', 'Suat Gonul', 'Subashan Perera', 'Sundaresan Murugesan', 'Sungjae Jung', 'Susan Gruber', 'Susan R Heckbert', 'Suzanne Bakken', 'Sylvester Sakilay', 'T Ganslandt', 'T Herrmann', 'Tal Lorberbaum', 'Tao Shan', 'Theodore C Goldstein', 'Theresa L Walunas', 'Thomas Ganslandt', 'Thorsten Schwachhofer', 'Tian Kang', 'Tiffany J Callahan', 'Till Acker', 'Tim Varley', 'Tina M Hernandez-Boussard', 'Toan C Ong', 'Todd Lingren', 'Traci Yamashita', 'Trevor Cohen', 'Usman Iqbal', 'Valentina Barletta', 'Victor Nwankwo', 'Victoria L Bartlett', 'Vinit P Nair', 'Virginia Rentko', 'Vitor Santos Costa', 'Vivek Rudrapatna', 'Vivian S Gainer', 'Vivienne Zhu', 'Vojtech Huser', 'W DuMouchel', 'W Nick Street', 'Walter Cazzola', 'Walter Gall', 'Wei-Qi Wei', 'Werner Ceusters', 'William DuMouchel', 'William Hinton', 'Xiangrui Meng', 'Xiaochun Li', 'Xiaofeng Zhou', 'Xiaoliang Zhang', 'Xin Zhang', 'Xue Li', 'Y X Sun', 'Yanming Xie', 'Yeonsoo Hwang', 'Yihua Xu', 'Ying Li', 'Ying Wei', 'Yinying Lu', 'Yixuan Guo', 'Yizhen Zhang', 'Yizhen Zhong', 'Yola Moride', 'Yonghui Wu', 'Yoni Halpern', 'Youlan Tang', 'Youngjun Kim', 'Yu Rang Park', 'Yu Yang', 'Yu-Chuan Li', 'Yuan Luo', 'Yue Yu', 'Yuechuchu Yin', 'Yueshi Zhu', 'Yuji Feng', 'Yun Liu', 'Yuqi Si', 'Yuriy Khoma', 'Yuval Elovici', 'Yuval Shahar', 'Z C Pei', 'Zach Shahn', 'Zachary H Moldwin', 'Zachary Shahn', 'Zhaobin Kuang', 'Zhenxing Xu', 'Zhong Yuan', 'Zhongmin Wang', 'Zhongqiu Huang', 'Ziran Li', 'Zuolei Dai', 'hommeaux Eri']",147,582
8,2020,"Xu Zuo, Anna Ostropolets, Martijn J Schuemie, Pascal S Brandt, Jingqi Wang, Jennifer C E Lane, Ines Reinecke, Yu Tian, Yue Yu, Nicolas H Thurin, Edward Burn, Yue Yu, Fatemah A Alnofal, Rebecca E Chandler, Jenna M Reps, Mehr Kashyap, Youn I Choi, Brian E Dixon, Nicolas H Thurin, Joel N Swerdel, Qiong Wang, Anna Ostropolets, Jiayi Tong, Anusha Bompelli, Borim Ryu, Seungho Jeon, Jaehyeong Cho, Sylvia Cho, Gabriel A Brat, Christel Daniel, Shorabuddin Syed, Yeesuk Kim, Mirko Gruhl, Patrick Fischer, Philipp Unberath, Chelsea L Michael, Hunmin Kim, Hyerim Ji, Gianmario Candore, Antoine Lamer, Sijia Liu, Divneet Mandair, Ruijun Chen, Seung In Seo, Premanand Tiwari, Ruth Brauer, Seng Chan You, Praveen Kumar, Matthew E Spotnitz, George Hripcsak, Simon Lovestone, Chunhua Weng, Zhong Yuan, Amelia J Averitt, Matthew E Spotnitz, Lena Davidson, Alison Callahan, Rachel B Weinstein, Amelia J Averitt, Martijn J Schuemie, Martijn J Schuemie, Chien-Chou Su, Simon de Lusignan, Seng Chan You, Edward Burn, Rui Duan, Nicholas J Dobbins, Daniel R Harris","['Abraham G Hartzema', 'Alex Butler', 'Alison Callahan', 'Amelia J Averitt', 'Amy Matcho', 'Anando Sen', 'Andrea Haberson', 'Anil Pacaci', 'Anna Ostropolets', 'Antoine Lamer', 'Anusha Bompelli', 'Benjamin S Glicksberg', 'Benjamin Viernes', 'Borim Ryu', 'Brian E Dixon', 'C Maier', 'Casey N Ta', 'Chelsea L Michael', 'Chi Yuan', 'Chien-Chou Su', 'Christel Daniel', 'Christian Reich', 'Christoph Rinner', 'Chunhua Weng', 'Daniel M Lima', 'Divneet Mandair', 'Dukyong Yoon', 'E A Voss', 'Edeltraut Garbe', 'Edward Burn', 'Erica A Voss', 'F FitzHenry', 'Fatemah A Alnofal', 'Fernanda C G Polubriaginof', 'Frank J Defalco', 'G Trifiro', 'Gabriel A Brat', 'George Hripcsak', 'Gianmario Candore', 'Guan N Guo', 'Guoqian Jiang', 'Hans-Ulrich Prokosch', 'Harshana Liyanage', 'Himanshu Sharma', 'Hong Sun', 'Hunmin Kim', 'Hyeoneui Kim', 'Hyerim Ji', 'Ines Reinecke', 'Jaehyeong Cho', 'James R Rogers', 'Jeffrey G Klann', 'Jenna M Reps', 'Jennifer C E Lane', 'Jeremy L Warner', 'Jiayi Tong', 'Jingqi Wang', 'Joel N Swerdel', 'John Weeks', 'Jon D Duke', 'Jonathan C Blaisure', 'Juan M Banda', 'Julian Gruendner', 'Justin Mower', 'Kristine E Lynch', 'Lena Davidson', 'Lian Lian Duan', 'Lu Wang', 'Luke V Rasmussen', 'Manfred Hauben', 'Manlik Kwong', 'Marc A Suchard', 'Martijn J Schuemie', 'Martin G Seneviratne', 'Mary Regina Boland', 'Maryam Garza', 'Matthew E Levine', 'Matthew E Spotnitz', 'Matthias Samwald', 'Mehr Kashyap', 'Minh Pham', 'Mirko Gruhl', 'Mohammed Khalilia', 'Na Hong', 'Nicholas J Dobbins', 'Nicolas H Thurin', 'Ning Shang', 'Nir Nissim', 'Omolola I Ogunyemi', 'Pascal S Brandt', 'Patrick B Ryan', 'Patrick Fischer', 'Paul E Stang', 'Peter L Elkin', 'Peter R Rijnbeek', 'Philipp Unberath', 'Praveen Kumar', 'Premanand Tiwari', 'Qiong Wang', 'R Harpaz', 'R W White', 'Rachel B Weinstein', 'Rae Woong Park', 'Rebecca E Chandler', 'Richard A Hansen', 'Richard D Boyce', 'Rimma Belenkaya', 'Robert Moskovitch', 'Rohit Vashisht', 'Rosa Gini', 'Rui Duan', 'Ruijun Chen', 'Rupa Makadia', 'Ruth Brauer', 'Ryan M Carnahan', 'S T Rosenbloom', 'S Vilar', 'Santiago Vilar', 'Seng Chan You', 'Seo Jeong Shin', 'Seung In Seo', 'Seungho Jeon', 'Shorabuddin Syed', 'Shreya Chakrabarti', 'Sigfried Gold', 'Sijia Liu', 'Simon Lovestone', 'Simon de Lusignan', 'Stephane M Meystre', 'Susan Gruber', 'Sylvia Cho', 'Tian Kang', 'Tiffany J Callahan', 'Toan C Ong', 'Victoria L Bartlett', 'Vojtech Huser', 'Werner Ceusters', 'Xiaochun Li', 'Xiaofeng Zhou', 'Xin Zhang', 'Xu Zuo', 'Y X Sun', 'Yeesuk Kim', 'Yihua Xu', 'Ying Li', 'Youn I Choi', 'Yu Tian', 'Yu Yang', 'Yue Yu', 'Yuqi Si', 'Zhaobin Kuang', 'Zhong Yuan', 'nan']",51,153,"['Xu, Zuo', 'Jianfu, Li', 'Bo, Zhao', 'Yujia, Zhou', 'Xiao, Dong', 'Jon, Duke', 'Karthik, Natarajan', 'George, Hripcsak', 'Nigam, Shah', 'Juan M, Banda', 'Ruth, Reeves', 'Timothy, Miller', 'Hua, Xu'], ['Anna, Ostropolets', 'Christian, Reich', 'Patrick, Ryan', 'Chunhua, Weng', 'Anthony, Molinaro', 'Frank, DeFalco', 'Jitendra, Jonnagaddala', 'Siaw-Teng, Liaw', 'Hokyun, Jeon', 'Rae Woong, Park', 'Matthew E, Spotnitz', 'Karthik, Natarajan', 'George, Argyriou', 'Kristin, Kostka', 'Robert, Miller', 'Andrew, Williams', 'Evan, Minty', 'Jose, Posada', 'George, Hripcsak'], ['Martijn J, Schuemie', 'M Soledad, Cepeda', 'Marc A, Suchard', 'Jianxiao, Yang', 'Yuxi, Tian', 'Alejandro, Schuler', 'Patrick B, Ryan', 'David, Madigan', 'George, Hripcsak'], ['Pascal S, Brandt', 'Richard C, Kiefer', 'Jennifer A, Pacheco', 'Prakash, Adekkanattu', 'Evan T, Sholle', 'Faraz S, Ahmad', 'Jie, Xu', 'Zhenxing, Xu', 'Jessica S, Ancker', 'Fei, Wang', 'Yuan, Luo', 'Guoqian, Jiang', 'Jyotishman, Pathak', 'Luke V, Rasmussen'], ['Jingqi, Wang', 'Huy, Anh', 'Frank, Manion', 'Masoud, Rouhizadeh', 'Yaoyun, Zhang'], ['Jennifer C E, Lane', 'James, Weaver', 'Kristin, Kostka', 'Talita, Duarte-Salles', 'Maria Tereza F, Abrahao', 'Heba, Alghoul', 'Osaid, Alser', 'Thamir M, Alshammari', 'Patricia, Biedermann', 'Juan M, Banda', 'Edward, Burn', 'Paula, Casajust', 'Mitchell M, Conover', 'Aedin C, Culhane', 'Alexander, Davydov', 'Scott L, DuVall', 'Dmitry, Dymshyts', 'Sergio, Fernandez-Bertolin', 'Kristina, Fister', 'Jill, Hardin', 'Laura, Hester', 'George, Hripcsak', 'Benjamin Skov, Kaas-Hansen', 'Seamus, Kent', 'Sajan, Khosla', 'Spyros, Kolovos', 'Christophe G, Lambert', 'Johan, van der Lei', 'Kristine E, Lynch', 'Rupa, Makadia', 'Andrea V, Margulis', 'Michael E, Matheny', 'Paras, Mehta', 'Daniel R, Morales', 'Henry, Morgan-Stewart', 'Mees, Mosseveld', 'Danielle, Newby', 'Fredrik, Nyberg', 'Anna, Ostropolets', 'Rae Woong, Park', 'Albert, Prats-Uribe', 'Gowtham A, Rao', 'Christian, Reich', 'Jenna, Reps', 'Peter, Rijnbeek', 'Selva Muthu Kumaran, Sathappan', 'Martijn, Schuemie', 'Sarah, Seager', 'Anthony G, Sena', 'Azza, Shoaibi', 'Matthew, Spotnitz', 'Marc A, Suchard', 'Carmen O, Torre', 'David, Vizcaya', 'Haini, Wen', 'Marcel, de Wilde', 'Junqing, Xie', 'Seng Chan, You', 'Lin, Zhang', 'Oleg, Zhuk', 'Patrick, Ryan', 'Daniel, Prieto-Alhambra'], ['Ines, Reinecke', 'Christian, Gulden', 'Michele, Kummel', 'Azadeh, Nassirian', 'Romina, Blasini', 'Martin, Sedlmayr'], ['Yu, Tian', 'Weiguo, Chen', 'Tianshu, Zhou', 'Jun, Li', 'Kefeng, Ding', 'Jingsong, Li'], ['Yue, Yu', 'Kathryn, Ruddy', 'Aaron, Mansfield', 'Nansu, Zong', 'Andrew, Wen', 'Shintaro, Tsuji', 'Ming, Huang', 'Hongfang, Liu', 'Nilay, Shah', 'Guoqian, Jiang'], ['Nicolas H, Thurin', 'Regis, Lassalle', 'Martijn, Schuemie', 'Marine, Penichon', 'Joshua J, Gagne', 'Jeremy A, Rassen', 'Jacques, Benichou', 'Alain, Weill', 'Patrick, Blin', 'Nicholas, Moore', 'Cecile, Droz-Perroteau'], ['Edward, Burn', 'Seng Chan, You', 'Anthony, Sena', 'Kristin, Kostka', 'Hamed, Abedtash', 'Maria Tereza F, Abrahao', 'Amanda, Alberga', 'Heba, Alghoul', 'Osaid, Alser', 'Thamir M, Alshammari', 'Maria, Aragon', 'Carlos, Areia', 'Juan M, Banda', 'Jaehyeong, Cho', 'Aedin C, Culhane', 'Alexander, Davydov', 'Frank J, DeFalco', 'Talita, Duarte-Salles', 'Scott L, DuVall', 'Thomas, Falconer', 'Sergio, Fernandez-Bertolin', 'Weihua, Gao', 'Asieh, Golozar', 'Jill, Hardin', 'George, Hripcsak', 'Vojtech, Huser', 'Hokyun, Jeon', 'Yonghua, Jing', 'Chi Young, Jung', 'Benjamin Skov, Kaas-Hansen', 'Denys, Kaduk', 'Seamus, Kent', 'Yeesuk, Kim', 'Spyros, Kolovos', 'Jennifer, Lane', 'Hyejin, Lee', 'Kristine E, Lynch', 'Rupa, Makadia', 'Michael E, Matheny', 'Paras, Mehta', 'Daniel R, Morales', 'Karthik, Natarajan', 'Fredrik, Nyberg', 'Anna, Ostropolets', 'Rae Woong, Park', 'Jimyung, Park', 'Jose D, Posada', 'Albert, Prats-Uribe', 'Gowtham A, Rao', 'Christian, Reich', 'Yeunsook, Rho', 'Peter, Rijnbeek', 'Lisa M, Schilling', 'Martijn, Schuemie', 'Nigam H, Shah', 'Azza, Shoaibi', 'Seokyoung, Song', 'Matthew, Spotnitz', 'Marc A, Suchard', 'Joel, Swerdel', 'David, Vizcaya', 'Salvatore, Volpe', 'Haini, Wen', 'Andrew E, Williams', 'Belay B, Yimer', 'Lin, Zhang', 'Oleg, Zhuk', 'Daniel, Prieto-Alhambra', 'Patrick, Ryan'], ['Yue, Yu', 'Kathryn J, Ruddy', 'Andrew, Wen', 'Nansu, Zong', 'Shintaro, Tsuji', 'Jun, Chen', 'Nilay D, Shah', 'Guoqian, Jiang'], ['Fatemah A, Alnofal', 'Adel A, Alrwisan', 'Thamir M, Alshammari'], ['Rebecca E, Chandler'], ['Jenna M, Reps', 'Ross D, Williams', 'Seng Chan, You', 'Thomas, Falconer', 'Evan, Minty', 'Alison, Callahan', 'Patrick B, Ryan', 'Rae Woong, Park', 'Hong-Seok, Lim', 'Peter, Rijnbeek'], ['Mehr, Kashyap', 'Martin, Seneviratne', 'Juan M, Banda', 'Thomas, Falconer', 'Borim, Ryu', 'Sooyoung, Yoo', 'George, Hripcsak', 'Nigam H, Shah'], ['Youn I, Choi', 'Yoon Jae, Kim', 'Jun-Won, Chung', 'Kyoung Oh, Kim', 'Hakki, Kim', 'Rae Woong, Park', 'Dong Kyun, Park'], ['Brian E, Dixon', 'Chen, Wen', 'Tony, French', 'Jennifer L, Williams', 'Jon D, Duke', 'Shaun J, Grannis'], ['Nicolas H, Thurin', 'Regis, Lassalle', 'Martijn, Schuemie', 'Marine, Penichon', 'Joshua J, Gagne', 'Jeremy A, Rassen', 'Jacques, Benichou', 'Alain, Weill', 'Patrick, Blin', 'Nicholas, Moore', 'Cecile, Droz-Perroteau'], ['Joel N, Swerdel', 'Jenna M, Reps', 'Daniel, Fife', 'Patrick B, Ryan'], ['Qiong, Wang', 'Jenna M, Reps', 'Kristin Feeney, Kostka', 'Patrick B, Ryan', 'Yuhui, Zou', 'Erica A, Voss', 'Peter R, Rijnbeek', 'RuiJun, Chen', 'Gowtham A, Rao', 'Henry, Morgan Stewart', 'Andrew E, Williams', 'Ross D, Williams', 'Mui, Van Zandt', 'Thomas, Falconer', 'Margarita, Fernandez-Chas', 'Rohit, Vashisht', 'Stephen R, Pfohl', 'Nigam H, Shah', 'Suranga N, Kasthurirathne', 'Seng Chan, You', 'Qing, Jiang', 'Christian, Reich', 'Yi, Zhou'], ['Anna, Ostropolets', 'Christian, Reich', 'Patrick, Ryan', 'Ning, Shang', 'George, Hripcsak', 'Chunhua, Weng'], ['Jiayi, Tong', 'Rui, Duan', 'Ruowang, Li', 'Martijn J, Scheuemie', 'Jason H, Moore', 'Yong, Chen'], ['Anusha, Bompelli', 'Jianfu, Li', 'Yiqi, Xu', 'Nan, Wang', 'Yanshan, Wang', 'Terrence, Adam', 'Zhe, He', 'Rui, Zhang'], ['Borim, Ryu', 'Eunsil, Yoon', 'Seok, Kim', 'Sejoon, Lee', 'Hyunyoung, Baek', 'Soyoung, Yi', 'Hee Young, Na', 'Ji-Won, Kim', 'Rong-Min, Baek', 'Hee, Hwang', 'Sooyoung, Yoo'], ['Seungho, Jeon', 'Jeongeun, Seo', 'Sukyoung, Kim', 'Jeongmoon, Lee', 'Jong-Ho, Kim', 'Jang Wook, Sohn', 'Jongsub, Moon', 'Hyung Joon, Joo'], ['Jaehyeong, Cho', 'Seng Chan, You', 'Seongwon, Lee', 'DongSu, Park', 'Bumhee, Park', 'George, Hripcsak', 'Rae Woong, Park'], ['Sylvia, Cho', 'Margaret, Sin', 'Demetra, Tsapepas', 'Leigh-Anne, Dale', 'Syed A, Husain', 'Sumit, Mohan', 'Karthik, Natarajan'], ['Gabriel A, Brat', 'Griffin M, Weber', 'Nils, Gehlenborg', 'Paul, Avillach', 'Nathan P, Palmer', 'Luca, Chiovato', 'James, Cimino', 'Lemuel R, Waitman', 'Gilbert S, Omenn', 'Alberto, Malovini', 'Jason H, Moore', 'Brett K, Beaulieu-Jones', 'Valentina, Tibollo', 'Shawn N, Murphy', ', ""', ', ', ', ', ', ', ', ', ', ', ', ', ', ', ', ', ', ', ', ', ', ', ', ', ', ', ', ', ', ', ', ', ', ', ', ', ', ', ', ', ', ', ', ', ', ', ', ', ', ', ', ', ', ', ', ', ', ', ', ', ', ', ', ', ', ', ', ', ', ', ', ', ', ', ', ', ', ', ', ', ', ', ', ', ', ', ', ', ', ', ', ', ', ', ', ', ', ', ', ', ', ', ', ', ', ', ', ', ', ', ', ', ', ', ', ', ', ', ', ', ', ', ', ', ', ', ', ', ', ', ', ', ', ', ', ', ', ', ', ', ', ', ], ['Christel, Daniel', 'Dipak, Kalra'], ['Shorabuddin, Syed', 'Ahmad, Baghal', 'Fred, Prior', 'Meredith, Zozus', 'Shaymaa, Al-Shukri', 'Hafsa Bareen, Syeda', 'Maryam, Garza', 'Salma, Begum', 'Kim, Gates', 'Mahanazuddin, Syed', 'Kevin W, Sexton'], ['Yeesuk, Kim', 'Yuxi, Tian', 'Jianxiao, Yang', 'Vojtech, Huser', 'Peng, Jin', 'Christophe G, Lambert', 'Hojun, Park', 'Seng Chan, You', 'Rae Woong, Park', 'Peter R, Rijnbeek', 'Mui, Van Zandt', 'Christian, Reich', 'Rohit, Vashisht', 'Yonghui, Wu', 'Jon, Duke', 'George, Hripcsak', 'David, Madigan', 'Nigam H, Shah', 'Patrick B, Ryan', 'Martijn J, Schuemie', 'Marc A, Suchard'], ['Mirko, Gruhl', 'Ines, Reinecke', 'Martin, Sedlmayr'], ['Patrick, Fischer', 'Mark R, Stohr', 'Henning, Gall', 'Achim, Michel-Backofen', 'Raphael W, Majeed'], ['Philipp, Unberath', 'Hans Ulrich, Prokosch', 'Julian, Grundner', 'Marcel, Erpenbeck', 'Christian, Maier', 'Jan, Christoph'], ['Chelsea L, Michael', 'Evan T, Sholle', 'Regina T, Wulff', 'Gail J, Roboz', 'Thomas R Jr, Campion'], ['Hunmin, Kim', 'Sooyoung, Yoo', 'Yonghoon, Jeon', 'Soyoung, Yi', 'Seok, Kim', 'Sun Ah, Choi', 'Hee, Hwang', 'Ki Joong, Kim'], ['Hyerim, Ji', 'Seok, Kim', 'Soyoung, Yi', 'Hee, Hwang', 'Jeong-Whun, Kim', 'Sooyoung, Yoo'], ['Gianmario, Candore', 'Karin, Hedenmalm', 'Jim, Slattery', 'Alison, Cave', 'Xavier, Kurz', 'Peter, Arlett'], ['Antoine, Lamer', 'Nicolas, Depas', 'Matthieu, Doutreligne', 'Adrien, Parrot', 'David, Verloop', 'Marguerite-Marie, Defebvre', 'Gregoire, Ficheur', 'Emmanuel, Chazard', 'Jean-Baptiste, Beuscart'], ['Sijia, Liu', 'Yanshan, Wang', 'Andrew, Wen', 'Liwei, Wang', 'Na, Hong', 'Feichen, Shen', 'Steven, Bedrick', 'William, Hersh', 'Hongfang, Liu'], ['Divneet, Mandair', 'Premanand, Tiwari', 'Steven, Simon', 'Kathryn L, Colborn', 'Michael A, Rosenberg'], ['Ruijun, Chen', 'Patrick, Ryan', 'Karthik, Natarajan', 'Thomas, Falconer', 'Katherine D, Crew', 'Christian G, Reich', 'Rohit, Vashisht', 'Gurvaneet, Randhawa', 'Nigam H, Shah', 'George, Hripcsak'], ['Seung In, Seo', 'Seng Chan, You', 'Chan Hyuk, Park', 'Tae Joon, Kim', 'You Sang, Ko', 'Yerim, Kim', 'Jong Jin, Yoo', 'Jinseob, Kim', 'Woon Geon, Shin'], ['Premanand, Tiwari', 'Kathryn L, Colborn', 'Derek E, Smith', 'Fuyong, Xing', 'Debashis, Ghosh', 'Michael A, Rosenberg'], ['Ruth, Brauer', 'Ian Chi Kei, Wong', 'Kenneth Kc, Man', 'Nicole L, Pratt', 'Rae Woong, Park', 'Soo-Yeon, Cho', 'Yu-Chuan Jack, Li', 'Usman, Iqbal', 'Phung-Anh Alex, Nguyen', 'Martijn, Schuemie'], ['Seng Chan, You', 'Sungjae, Jung', 'Joel N, Swerdel', 'Patrick B, Ryan', 'Martijn J, Schuemie', 'Marc A, Suchard', 'Seongwon, Lee', 'Jaehyeong, Cho', 'George, Hripcsak', 'Rae Woong, Park', 'Sungha, Park'], ['Praveen, Kumar', 'Anastasiya, Nestsiarovich', 'Stuart J, Nelson', 'Berit, Kerner', 'Douglas J, Perkins', 'Christophe G, Lambert'], ['Matthew E, Spotnitz', 'Karthik, Natarajan', 'Patrick B, Ryan', 'Carolyn L, Westhoff'], ['George, Hripcsak', 'Marc A, Suchard', 'Steven, Shea', 'RuiJun, Chen', 'Seng Chan, You', 'Nicole, Pratt', 'David, Madigan', 'Harlan M, Krumholz', 'Patrick B, Ryan', 'Martijn J, Schuemie'], ['Simon, Lovestone'], ['Chunhua, Weng', 'Nigam H, Shah', 'George, Hripcsak'], ['Zhong, Yuan', 'Frank, DeFalco', 'Lu, Wang', 'Laura, Hester', 'James, Weaver', 'Joel N, Swerdel', 'Amy, Freedman', 'Patrick, Ryan', 'Martijn, Schuemie', 'Rose, Qiu', 'Jacqueline, Yee', 'Gary, Meininger', 'Jesse A, Berlin', 'Norman, Rosenthal'], ['Amelia J, Averitt', 'Chunhua, Weng', 'Patrick, Ryan', 'Adler, Perotte'], ['Matthew E, Spotnitz', 'Karthik, Natarajan', 'Patrick B, Ryan', 'Carolyn L, Westhoff'], ['Lena, Davidson', 'Mary Regina, Boland'], ['Alison, Callahan', 'Nigam H, Shah', 'Jonathan H, Chen'], ['Rachel B, Weinstein', 'Patrick B, Ryan', 'Jesse A, Berlin', 'Martijn J, Schuemie', 'Joel, Swerdel', 'Daniel, Fife'], ['Amelia J, Averitt', 'Natnicha, Vanitchanant', 'Rajesh, Ranganath', 'Adler J, Perotte'], ['Martijn J, Schuemie', 'Patrick B, Ryan', 'Nicole, Pratt', 'RuiJun, Chen', 'Seng Chan, You', 'Harlan M, Krumholz', 'David, Madigan', 'George, Hripcsak', 'Marc A, Suchard'], ['Martijn J, Schuemie', 'Patrick B, Ryan', 'Nicole, Pratt', 'RuiJun, Chen', 'Seng Chan, You', 'Harlan M, Krumholz', 'David, Madigan', 'George, Hripcsak', 'Marc A, Suchard'], ['Chien-Chou, Su', 'Edward, Chia-Cheng Lai', 'Yea-Huei, Kao Yang', 'Kenneth K C, Man', 'Kiyoshi, Kubota', 'Paul, Stang', 'Martijn, Schuemie', 'Patrick, Ryan', 'Chantelle, Hardy', 'Yinghong, Zhang', 'Shinya, Kimura', 'Yukari, Kamijima', 'Ian C K, Wong', 'Soko, Setoguchi'], ['Simon, de Lusignan', 'Nicholas, Jones', 'Jienchi, Dorward', 'Rachel, Byford', 'Harshana, Liyanage', 'John, Briggs', 'Filipa, Ferreira', 'Oluwafunmi, Akinyemi', 'Gayatri, Amirthalingam', 'Chris, Bates', 'Jamie, Lopez Bernal', 'Gavin, Dabrera', 'Alex, Eavis', 'Alex J, Elliot', 'Michael, Feher', 'Else, Krajenbrink', 'Uy, Hoang', 'Gary, Howsam', 'Jonathan, Leach', 'Cecilia, Okusi', 'Brian, Nicholson', 'Philip, Nieri', 'Julian, Sherlock', 'Gillian, Smith', 'Mark, Thomas', 'Nicholas, Thomas', 'Manasa, Tripathy', 'William, Victor', 'John, Williams', 'Ian, Wood', 'Maria, Zambon', 'John, Parry', ', Hanlon, Shaun""', ', ', ', ', ', ', ], ['Seng Chan, You', 'Yeunsook, Rho', 'Behnood, Bikdeli', 'Jiwoo, Kim', 'Anastasios, Siapos', 'James, Weaver', 'Ajit, Londhe', 'Jaehyeong, Cho', 'Jimyung, Park', 'Martijn, Schuemie', 'Marc A, Suchard', 'David, Madigan', 'George, Hripcsak', 'Aakriti, Gupta', 'Christian G, Reich', 'Patrick B, Ryan', 'Rae Woong, Park', 'Harlan M, Krumholz'], ['Edward, Burn', 'Seng Chan, You', 'Anthony G, Sena', 'Kristin, Kostka', 'Hamed, Abedtash', 'Maria Tereza F, Abrahao', 'Amanda, Alberga', 'Heba, Alghoul', 'Osaid, Alser', 'Thamir M, Alshammari', 'Maria, Aragon', 'Carlos, Areia', 'Juan M, Banda', 'Jaehyeong, Cho', 'Aedin C, Culhane', 'Alexander, Davydov', 'Frank J, DeFalco', 'Talita, Duarte-Salles', 'Scott, DuVall', 'Thomas, Falconer', 'Sergio, Fernandez-Bertolin', 'Weihua, Gao', 'Asieh, Golozar', 'Jill, Hardin', 'George, Hripcsak', 'Vojtech, Huser', 'Hokyun, Jeon', 'Yonghua, Jing', 'Chi Young, Jung', 'Benjamin Skov, Kaas-Hansen', 'Denys, Kaduk', 'Seamus, Kent', 'Yeesuk, Kim', 'Spyros, Kolovos', 'Jennifer C E, Lane', 'Hyejin, Lee', 'Kristine E, Lynch', 'Rupa, Makadia', 'Michael E, Matheny', 'Paras P, Mehta', 'Daniel R, Morales', 'Karthik, Natarajan', 'Fredrik, Nyberg', 'Anna, Ostropolets', 'Rae Woong, Park', 'Jimyung, Park', 'Jose D, Posada', 'Albert, Prats-Uribe', 'Gowtham, Rao', 'Christian, Reich', 'Yeunsook, Rho', 'Peter, Rijnbeek', 'Lisa M, Schilling', 'Martijn, Schuemie', 'Nigam H, Shah', 'Azza, Shoaibi', 'Seokyoung, Song', 'Matthew, Spotnitz', 'Marc A, Suchard', 'Joel N, Swerdel', 'David, Vizcaya', 'Salvatore, Volpe', 'Haini, Wen', 'Andrew E, Williams', 'Belay B, Yimer', 'Lin, Zhang', 'Oleg, Zhuk', 'Daniel, Prieto-Alhambra', 'Patrick, Ryan'], ['Rui, Duan', 'Chongliang, Luo', 'Martijn J, Schuemie', 'Jiayi, Tong', 'C Jason, Liang', 'Howard H, Chang', 'Mary Regina, Boland', 'Jiang, Bian', 'Hua, Xu', 'John H, Holmes', 'Christopher B, Forrest', 'Sally C, Morton', 'Jesse A, Berlin', 'Jason H, Moore', 'Kevin B, Mahoney', 'Yong, Chen'], ['Nicholas J, Dobbins', 'Clifford H, Spital', 'Robert A, Black', 'Jason M, Morrison', 'Bas, de Veer', 'Elizabeth, Zampino', 'Robert D, Harrington', 'Bethene D, Britt', 'Kari A, Stephens', 'Adam B, Wilcox', 'Peter, Tarczy-Hornoch', 'Sean D, Mooney'], ['Daniel R, Harris']","'Xu Zuo', 'Jianfu Li', 'Bo Zhao', 'Yujia Zhou', 'Xiao Dong', 'Jon Duke', 'Karthik Natarajan', 'George Hripcsak', 'Nigam Shah', 'Juan M Banda', 'Ruth Reeves', 'Timothy Miller', 'Hua Xu', 'Anna Ostropolets', 'Christian Reich', 'Patrick Ryan', 'Chunhua Weng', 'Anthony Molinaro', 'Frank DeFalco', 'Jitendra Jonnagaddala', 'Siaw-Teng Liaw', 'Hokyun Jeon', 'Rae Woong Park', 'Matthew E Spotnitz', 'Karthik Natarajan', 'George Argyriou', 'Kristin Kostka', 'Robert Miller', 'Andrew Williams', 'Evan Minty', 'Jose Posada', 'George Hripcsak', 'Martijn J Schuemie', 'M Soledad Cepeda', 'Marc A Suchard', 'Jianxiao Yang', 'Yuxi Tian', 'Alejandro Schuler', 'Patrick B Ryan', 'David Madigan', 'George Hripcsak', 'Pascal S Brandt', 'Richard C Kiefer', 'Jennifer A Pacheco', 'Prakash Adekkanattu', 'Evan T Sholle', 'Faraz S Ahmad', 'Jie Xu', 'Zhenxing Xu', 'Jessica S Ancker', 'Fei Wang', 'Yuan Luo', 'Guoqian Jiang', 'Jyotishman Pathak', 'Luke V Rasmussen', 'Jingqi Wang', 'Huy Anh', 'Frank Manion', 'Masoud Rouhizadeh', 'Yaoyun Zhang', 'Jennifer C E Lane', 'James Weaver', 'Kristin Kostka', 'Talita Duarte-Salles', 'Maria Tereza F Abrahao', 'Heba Alghoul', 'Osaid Alser', 'Thamir M Alshammari', 'Patricia Biedermann', 'Juan M Banda', 'Edward Burn', 'Paula Casajust', 'Mitchell M Conover', 'Aedin C Culhane', 'Alexander Davydov', 'Scott L DuVall', 'Dmitry Dymshyts', 'Sergio Fernandez-Bertolin', 'Kristina Fister', 'Jill Hardin', 'Laura Hester', 'George Hripcsak', 'Benjamin Skov Kaas-Hansen', 'Seamus Kent', 'Sajan Khosla', 'Spyros Kolovos', 'Christophe G Lambert', 'Johan van der Lei', 'Kristine E Lynch', 'Rupa Makadia', 'Andrea V Margulis', 'Michael E Matheny', 'Paras Mehta', 'Daniel R Morales', 'Henry Morgan-Stewart', 'Mees Mosseveld', 'Danielle Newby', 'Fredrik Nyberg', 'Anna Ostropolets', 'Rae Woong Park', 'Albert Prats-Uribe', 'Gowtham A Rao', 'Christian Reich', 'Jenna Reps', 'Peter Rijnbeek', 'Selva Muthu Kumaran Sathappan', 'Martijn Schuemie', 'Sarah Seager', 'Anthony G Sena', 'Azza Shoaibi', 'Matthew Spotnitz', 'Marc A Suchard', 'Carmen O Torre', 'David Vizcaya', 'Haini Wen', 'Marcel de Wilde', 'Junqing Xie', 'Seng Chan You', 'Lin Zhang', 'Oleg Zhuk', 'Patrick Ryan', 'Daniel Prieto-Alhambra', 'Ines Reinecke', 'Christian Gulden', 'Michele Kummel', 'Azadeh Nassirian', 'Romina Blasini', 'Martin Sedlmayr', 'Yu Tian', 'Weiguo Chen', 'Tianshu Zhou', 'Jun Li', 'Kefeng Ding', 'Jingsong Li', 'Yue Yu', 'Kathryn Ruddy', 'Aaron Mansfield', 'Nansu Zong', 'Andrew Wen', 'Shintaro Tsuji', 'Ming Huang', 'Hongfang Liu', 'Nilay Shah', 'Guoqian Jiang', 'Nicolas H Thurin', 'Regis Lassalle', 'Martijn Schuemie', 'Marine Penichon', 'Joshua J Gagne', 'Jeremy A Rassen', 'Jacques Benichou', 'Alain Weill', 'Patrick Blin', 'Nicholas Moore', 'Cecile Droz-Perroteau', 'Edward Burn', 'Seng Chan You', 'Anthony Sena', 'Kristin Kostka', 'Hamed Abedtash', 'Maria Tereza F Abrahao', 'Amanda Alberga', 'Heba Alghoul', 'Osaid Alser', 'Thamir M Alshammari', 'Maria Aragon', 'Carlos Areia', 'Juan M Banda', 'Jaehyeong Cho', 'Aedin C Culhane', 'Alexander Davydov', 'Frank J DeFalco', 'Talita Duarte-Salles', 'Scott L DuVall', 'Thomas Falconer', 'Sergio Fernandez-Bertolin', 'Weihua Gao', 'Asieh Golozar', 'Jill Hardin', 'George Hripcsak', 'Vojtech Huser', 'Hokyun Jeon', 'Yonghua Jing', 'Chi Young Jung', 'Benjamin Skov Kaas-Hansen', 'Denys Kaduk', 'Seamus Kent', 'Yeesuk Kim', 'Spyros Kolovos', 'Jennifer Lane', 'Hyejin Lee', 'Kristine E Lynch', 'Rupa Makadia', 'Michael E Matheny', 'Paras Mehta', 'Daniel R Morales', 'Karthik Natarajan', 'Fredrik Nyberg', 'Anna Ostropolets', 'Rae Woong Park', 'Jimyung Park', 'Jose D Posada', 'Albert Prats-Uribe', 'Gowtham A Rao', 'Christian Reich', 'Yeunsook Rho', 'Peter Rijnbeek', 'Lisa M Schilling', 'Martijn Schuemie', 'Nigam H Shah', 'Azza Shoaibi', 'Seokyoung Song', 'Matthew Spotnitz', 'Marc A Suchard', 'Joel Swerdel', 'David Vizcaya', 'Salvatore Volpe', 'Haini Wen', 'Andrew E Williams', 'Belay B Yimer', 'Lin Zhang', 'Oleg Zhuk', 'Daniel Prieto-Alhambra', 'Patrick Ryan', 'Yue Yu', 'Kathryn J Ruddy', 'Andrew Wen', 'Nansu Zong', 'Shintaro Tsuji', 'Jun Chen', 'Nilay D Shah', 'Guoqian Jiang', 'Fatemah A Alnofal', 'Adel A Alrwisan', 'Thamir M Alshammari', 'Rebecca E Chandler', 'Jenna M Reps', 'Ross D Williams', 'Seng Chan You', 'Thomas Falconer', 'Evan Minty', 'Alison Callahan', 'Patrick B Ryan', 'Rae Woong Park', 'Hong-Seok Lim', 'Peter Rijnbeek', 'Mehr Kashyap', 'Martin Seneviratne', 'Juan M Banda', 'Thomas Falconer', 'Borim Ryu', 'Sooyoung Yoo', 'George Hripcsak', 'Nigam H Shah', 'Youn I Choi', 'Yoon Jae Kim', 'Jun-Won Chung', 'Kyoung Oh Kim', 'Hakki Kim', 'Rae Woong Park', 'Dong Kyun Park', 'Brian E Dixon', 'Chen Wen', 'Tony French', 'Jennifer L Williams', 'Jon D Duke', 'Shaun J Grannis', 'Nicolas H Thurin', 'Regis Lassalle', 'Martijn Schuemie', 'Marine Penichon', 'Joshua J Gagne', 'Jeremy A Rassen', 'Jacques Benichou', 'Alain Weill', 'Patrick Blin', 'Nicholas Moore', 'Cecile Droz-Perroteau', 'Joel N Swerdel', 'Jenna M Reps', 'Daniel Fife', 'Patrick B Ryan', 'Qiong Wang', 'Jenna M Reps', 'Kristin Feeney Kostka', 'Patrick B Ryan', 'Yuhui Zou', 'Erica A Voss', 'Peter R Rijnbeek', 'RuiJun Chen', 'Gowtham A Rao', 'Henry Morgan Stewart', 'Andrew E Williams', 'Ross D Williams', 'Mui Van Zandt', 'Thomas Falconer', 'Margarita Fernandez-Chas', 'Rohit Vashisht', 'Stephen R Pfohl', 'Nigam H Shah', 'Suranga N Kasthurirathne', 'Seng Chan You', 'Qing Jiang', 'Christian Reich', 'Yi Zhou', 'Anna Ostropolets', 'Christian Reich', 'Patrick Ryan', 'Ning Shang', 'George Hripcsak', 'Chunhua Weng', 'Jiayi Tong', 'Rui Duan', 'Ruowang Li', 'Martijn J Scheuemie', 'Jason H Moore', 'Yong Chen', 'Anusha Bompelli', 'Jianfu Li', 'Yiqi Xu', 'Nan Wang', 'Yanshan Wang', 'Terrence Adam', 'Zhe He', 'Rui Zhang', 'Borim Ryu', 'Eunsil Yoon', 'Seok Kim', 'Sejoon Lee', 'Hyunyoung Baek', 'Soyoung Yi', 'Hee Young Na', 'Ji-Won Kim', 'Rong-Min Baek', 'Hee Hwang', 'Sooyoung Yoo', 'Seungho Jeon', 'Jeongeun Seo', 'Sukyoung Kim', 'Jeongmoon Lee', 'Jong-Ho Kim', 'Jang Wook Sohn', 'Jongsub Moon', 'Hyung Joon Joo', 'Jaehyeong Cho', 'Seng Chan You', 'Seongwon Lee', 'DongSu Park', 'Bumhee Park', 'George Hripcsak', 'Rae Woong Park', 'Sylvia Cho', 'Margaret Sin', 'Demetra Tsapepas', 'Leigh-Anne Dale', 'Syed A Husain', 'Sumit Mohan', 'Karthik Natarajan', 'Gabriel A Brat', 'Griffin M Weber', 'Nils Gehlenborg', 'Paul Avillach', 'Nathan P Palmer', 'Luca Chiovato', 'James Cimino', 'Lemuel R Waitman', 'Gilbert S Omenn', 'Alberto Malovini', 'Jason H Moore', 'Brett K Beaulieu-Jones', 'Valentina Tibollo', 'Shawn N Murphy', ', ""', ', ', ', ', ', ', ', ', ', ', ', ', ', ', ', ', ', ', ', ', ', ', ', ', ', ', ', ', ', ', ', ', ', ', ', ', ', ', ', ', ', ', ', ', ', ', ', ', ', ', ', ', ', ', ', ', ', ', ', ', ', ', ', ', ', ', ', ', ', ', ', ', ', ', ', ', ', ', ', ', ', ', ', ', ', ', ', ', ', ', ', ', ', ', ', ', ', ', ', ', ', ', ', ', ', ', ', ', ', ', ', ', ', ', ', ', ', ', ', ', ', ', ', ', ', ', ', ', ', ', ', ', ', ', ', ', ', ', ', ', ', ', , 'Christel Daniel', 'Dipak Kalra', 'Shorabuddin Syed', 'Ahmad Baghal', 'Fred Prior', 'Meredith Zozus', 'Shaymaa Al-Shukri', 'Hafsa Bareen Syeda', 'Maryam Garza', 'Salma Begum', 'Kim Gates', 'Mahanazuddin Syed', 'Kevin W Sexton', 'Yeesuk Kim', 'Yuxi Tian', 'Jianxiao Yang', 'Vojtech Huser', 'Peng Jin', 'Christophe G Lambert', 'Hojun Park', 'Seng Chan You', 'Rae Woong Park', 'Peter R Rijnbeek', 'Mui Van Zandt', 'Christian Reich', 'Rohit Vashisht', 'Yonghui Wu', 'Jon Duke', 'George Hripcsak', 'David Madigan', 'Nigam H Shah', 'Patrick B Ryan', 'Martijn J Schuemie', 'Marc A Suchard', 'Mirko Gruhl', 'Ines Reinecke', 'Martin Sedlmayr', 'Patrick Fischer', 'Mark R Stohr', 'Henning Gall', 'Achim Michel-Backofen', 'Raphael W Majeed', 'Philipp Unberath', 'Hans Ulrich Prokosch', 'Julian Grundner', 'Marcel Erpenbeck', 'Christian Maier', 'Jan Christoph', 'Chelsea L Michael', 'Evan T Sholle', 'Regina T Wulff', 'Gail J Roboz', 'Thomas R Jr Campion', 'Hunmin Kim', 'Sooyoung Yoo', 'Yonghoon Jeon', 'Soyoung Yi', 'Seok Kim', 'Sun Ah Choi', 'Hee Hwang', 'Ki Joong Kim', 'Hyerim Ji', 'Seok Kim', 'Soyoung Yi', 'Hee Hwang', 'Jeong-Whun Kim', 'Sooyoung Yoo', 'Gianmario Candore', 'Karin Hedenmalm', 'Jim Slattery', 'Alison Cave', 'Xavier Kurz', 'Peter Arlett', 'Antoine Lamer', 'Nicolas Depas', 'Matthieu Doutreligne', 'Adrien Parrot', 'David Verloop', 'Marguerite-Marie Defebvre', 'Gregoire Ficheur', 'Emmanuel Chazard', 'Jean-Baptiste Beuscart', 'Sijia Liu', 'Yanshan Wang', 'Andrew Wen', 'Liwei Wang', 'Na Hong', 'Feichen Shen', 'Steven Bedrick', 'William Hersh', 'Hongfang Liu', 'Divneet Mandair', 'Premanand Tiwari', 'Steven Simon', 'Kathryn L Colborn', 'Michael A Rosenberg', 'Ruijun Chen', 'Patrick Ryan', 'Karthik Natarajan', 'Thomas Falconer', 'Katherine D Crew', 'Christian G Reich', 'Rohit Vashisht', 'Gurvaneet Randhawa', 'Nigam H Shah', 'George Hripcsak', 'Seung In Seo', 'Seng Chan You', 'Chan Hyuk Park', 'Tae Joon Kim', 'You Sang Ko', 'Yerim Kim', 'Jong Jin Yoo', 'Jinseob Kim', 'Woon Geon Shin', 'Premanand Tiwari', 'Kathryn L Colborn', 'Derek E Smith', 'Fuyong Xing', 'Debashis Ghosh', 'Michael A Rosenberg', 'Ruth Brauer', 'Ian Chi Kei Wong', 'Kenneth Kc Man', 'Nicole L Pratt', 'Rae Woong Park', 'Soo-Yeon Cho', 'Yu-Chuan Jack Li', 'Usman Iqbal', 'Phung-Anh Alex Nguyen', 'Martijn Schuemie', 'Seng Chan You', 'Sungjae Jung', 'Joel N Swerdel', 'Patrick B Ryan', 'Martijn J Schuemie', 'Marc A Suchard', 'Seongwon Lee', 'Jaehyeong Cho', 'George Hripcsak', 'Rae Woong Park', 'Sungha Park', 'Praveen Kumar', 'Anastasiya Nestsiarovich', 'Stuart J Nelson', 'Berit Kerner', 'Douglas J Perkins', 'Christophe G Lambert', 'Matthew E Spotnitz', 'Karthik Natarajan', 'Patrick B Ryan', 'Carolyn L Westhoff', 'George Hripcsak', 'Marc A Suchard', 'Steven Shea', 'RuiJun Chen', 'Seng Chan You', 'Nicole Pratt', 'David Madigan', 'Harlan M Krumholz', 'Patrick B Ryan', 'Martijn J Schuemie', 'Simon Lovestone', 'Chunhua Weng', 'Nigam H Shah', 'George Hripcsak', 'Zhong Yuan', 'Frank DeFalco', 'Lu Wang', 'Laura Hester', 'James Weaver', 'Joel N Swerdel', 'Amy Freedman', 'Patrick Ryan', 'Martijn Schuemie', 'Rose Qiu', 'Jacqueline Yee', 'Gary Meininger', 'Jesse A Berlin', 'Norman Rosenthal', 'Amelia J Averitt', 'Chunhua Weng', 'Patrick Ryan', 'Adler Perotte', 'Matthew E Spotnitz', 'Karthik Natarajan', 'Patrick B Ryan', 'Carolyn L Westhoff', 'Lena Davidson', 'Mary Regina Boland', 'Alison Callahan', 'Nigam H Shah', 'Jonathan H Chen', 'Rachel B Weinstein', 'Patrick B Ryan', 'Jesse A Berlin', 'Martijn J Schuemie', 'Joel Swerdel', 'Daniel Fife', 'Amelia J Averitt', 'Natnicha Vanitchanant', 'Rajesh Ranganath', 'Adler J Perotte', 'Martijn J Schuemie', 'Patrick B Ryan', 'Nicole Pratt', 'RuiJun Chen', 'Seng Chan You', 'Harlan M Krumholz', 'David Madigan', 'George Hripcsak', 'Marc A Suchard', 'Martijn J Schuemie', 'Patrick B Ryan', 'Nicole Pratt', 'RuiJun Chen', 'Seng Chan You', 'Harlan M Krumholz', 'David Madigan', 'George Hripcsak', 'Marc A Suchard', 'Chien-Chou Su', 'Edward Chia-Cheng Lai', 'Yea-Huei Kao Yang', 'Kenneth K C Man', 'Kiyoshi Kubota', 'Paul Stang', 'Martijn Schuemie', 'Patrick Ryan', 'Chantelle Hardy', 'Yinghong Zhang', 'Shinya Kimura', 'Yukari Kamijima', 'Ian C K Wong', 'Soko Setoguchi', 'Simon de Lusignan', 'Nicholas Jones', 'Jienchi Dorward', 'Rachel Byford', 'Harshana Liyanage', 'John Briggs', 'Filipa Ferreira', 'Oluwafunmi Akinyemi', 'Gayatri Amirthalingam', 'Chris Bates', 'Jamie Lopez Bernal', 'Gavin Dabrera', 'Alex Eavis', 'Alex J Elliot', 'Michael Feher', 'Else Krajenbrink', 'Uy Hoang', 'Gary Howsam', 'Jonathan Leach', 'Cecilia Okusi', 'Brian Nicholson', 'Philip Nieri', 'Julian Sherlock', 'Gillian Smith', 'Mark Thomas', 'Nicholas Thomas', 'Manasa Tripathy', 'William Victor', 'John Williams', 'Ian Wood', 'Maria Zambon', 'John Parry', ', Hanlon Shaun""', ', ', ', ', ', ', , 'Seng Chan You', 'Yeunsook Rho', 'Behnood Bikdeli', 'Jiwoo Kim', 'Anastasios Siapos', 'James Weaver', 'Ajit Londhe', 'Jaehyeong Cho', 'Jimyung Park', 'Martijn Schuemie', 'Marc A Suchard', 'David Madigan', 'George Hripcsak', 'Aakriti Gupta', 'Christian G Reich', 'Patrick B Ryan', 'Rae Woong Park', 'Harlan M Krumholz', 'Edward Burn', 'Seng Chan You', 'Anthony G Sena', 'Kristin Kostka', 'Hamed Abedtash', 'Maria Tereza F Abrahao', 'Amanda Alberga', 'Heba Alghoul', 'Osaid Alser', 'Thamir M Alshammari', 'Maria Aragon', 'Carlos Areia', 'Juan M Banda', 'Jaehyeong Cho', 'Aedin C Culhane', 'Alexander Davydov', 'Frank J DeFalco', 'Talita Duarte-Salles', 'Scott DuVall', 'Thomas Falconer', 'Sergio Fernandez-Bertolin', 'Weihua Gao', 'Asieh Golozar', 'Jill Hardin', 'George Hripcsak', 'Vojtech Huser', 'Hokyun Jeon', 'Yonghua Jing', 'Chi Young Jung', 'Benjamin Skov Kaas-Hansen', 'Denys Kaduk', 'Seamus Kent', 'Yeesuk Kim', 'Spyros Kolovos', 'Jennifer C E Lane', 'Hyejin Lee', 'Kristine E Lynch', 'Rupa Makadia', 'Michael E Matheny', 'Paras P Mehta', 'Daniel R Morales', 'Karthik Natarajan', 'Fredrik Nyberg', 'Anna Ostropolets', 'Rae Woong Park', 'Jimyung Park', 'Jose D Posada', 'Albert Prats-Uribe', 'Gowtham Rao', 'Christian Reich', 'Yeunsook Rho', 'Peter Rijnbeek', 'Lisa M Schilling', 'Martijn Schuemie', 'Nigam H Shah', 'Azza Shoaibi', 'Seokyoung Song', 'Matthew Spotnitz', 'Marc A Suchard', 'Joel N Swerdel', 'David Vizcaya', 'Salvatore Volpe', 'Haini Wen', 'Andrew E Williams', 'Belay B Yimer', 'Lin Zhang', 'Oleg Zhuk', 'Daniel Prieto-Alhambra', 'Patrick Ryan', 'Rui Duan', 'Chongliang Luo', 'Martijn J Schuemie', 'Jiayi Tong', 'C Jason Liang', 'Howard H Chang', 'Mary Regina Boland', 'Jiang Bian', 'Hua Xu', 'John H Holmes', 'Christopher B Forrest', 'Sally C Morton', 'Jesse A Berlin', 'Jason H Moore', 'Kevin B Mahoney', 'Yong Chen', 'Nicholas J Dobbins', 'Clifford H Spital', 'Robert A Black', 'Jason M Morrison', 'Bas de Veer', 'Elizabeth Zampino', 'Robert D Harrington', 'Bethene D Britt', 'Kari A Stephens', 'Adam B Wilcox', 'Peter Tarczy-Hornoch', 'Sean D Mooney', 'Daniel R Harris'","['A Anil Sinaci', 'A Bauer-Mehren', 'Aakriti Gupta', 'Aaron Mansfield', 'Abraham G Hartzema', 'Achim Michel-Backofen', 'Adam B Wilcox', 'Adel A Alrwisan', 'Adler Perotte', 'Adrien Parrot', 'Aedin C Culhane', 'Agma J M Traina', 'Ahmad Baghal', 'Aize Cao', 'Ajit Londhe', 'Alain Weill', 'Alan E Bauck', 'Albert Prats-Uribe', 'Alberto Malovini', 'Alein T Chun', 'Alejandro Schuler', 'Alessandro Pasqua', 'Alex Butler', 'Alex Eavis', 'Alex J Elliot', 'Alexander Davydov', 'Alexander M Walker', 'Alexander Rusanov', 'Alexander Schoberl', 'Alexandra Jacunski', 'Alexandre Yahi', 'Alison Callahan', 'Alison Cave', 'Aliya Gifford', 'Aloka Chakravarty', 'Amanda Alberga', 'Amelia Henderson', 'Amelia J Averitt', 'Amy Freedman', 'Amy Matcho', 'Ana Szarfman', 'Anando Sen', 'Anastasios Siapos', 'Anastasiya Nestsiarovich', 'Andrea Batch', 'Andrea Donatini', 'Andrea Haberson', 'Andrea V Margulis', 'Andrew Bate', 'Andrew E Williams', 'Andrew Goldstein', 'Andrew Wen', 'Anil Pacaci', 'Anita Walden', 'Anna Ostropolets', 'Anthony G Sena', 'Anthony Molinaro', 'Anthony Reckard', 'Antoine Lamer', 'Anusha Bompelli', 'Asieh Golozar', 'Atul J Butte', 'Aviram Weiss', 'Azadeh Nassirian', 'Aziz Boxwala', 'Azza Shoaibi', 'B Mosseveld', 'Barbara Benoit', 'Bas de Veer', 'Behnood Bikdeli', 'Belay B Yimer', 'Benjamin S Glicksberg', 'Benjamin Skov Kaas-Hansen', 'Benjamin Teeter', 'Benjamin Viernes', 'Berit Kerner', 'Bethany M Kwan', 'Bethany Percha', 'Bethene D Britt', 'Bing Cai', 'Bo Zhao', 'Borim Ryu', 'Boris De Vloed', 'Boris Oskotsky', 'Brandon T Suehs', 'Brett K Beaulieu-Jones', 'Brett South', 'Brian C Sauer', 'Brian E Dixon', 'Brian Nicholson', 'Bruce M Psaty', 'Bruce N Davidson', 'Bumhee Park', 'C Friedman', 'C Haverkamp', 'C Jason Liang', 'C Maier', 'Carlos Areia', 'Carmelo Montalbano', 'Carmen O Torre', 'Carmen Schade-Brittinger', 'Carol Friedman', 'Carolyn D Britten', 'Carolyn L Westhoff', 'Casey N Ta', 'Cecile Droz-Perroteau', 'Cecilia Okusi', 'Chan Hyuk Park', 'Chantelle Hardy', 'Charles Bailey', 'Charles F 3rd Reynolds', 'Chelsea L Michael', 'Chen Wen', 'Chengsheng Mao', 'Chi Young Jung', 'Chi Yuan', 'Chien-Chou Su', 'Chongliang Luo', 'Chris Bates', 'Chris Knoll', 'Chris Uhrich', 'Christel Daniel', 'Christian Gulden', 'Christian Maier', 'Christian Reich', 'Christoph Rinner', 'Christophe G Lambert', 'Christopher B Forrest', 'Christopher Herrick', 'Christopher Wendl', 'Chuck Wentworth', 'Chunhua Weng', 'Clair Blacketer', 'Claudio Cricelli', 'Clifford H Spital', 'Cong Liu', 'D Madigan', 'D Meeker', 'D Weibel', 'Dae-Soon Son', 'Dahye Shin', 'Daniel B Aruch', 'Daniel C Malone', 'Daniel Fife', 'Daniel M Lima', 'Daniel Park', 'Daniel Prieto-Alhambra', 'Daniel R Morales', 'Daniella Meeker', 'Danielle Newby', 'David Bertoch', 'David Goldstein', 'David Gotz', 'David J Albers', 'David K Vawdrey', 'David Madigan', 'David Martin', 'David Page', 'David S Carrell', 'David Sontag', 'David Verloop', 'David Vizcaya', 'Debajyoti Datta', 'Debashis Ghosh', 'Deepak K Sharma', 'Demetra Tsapepas', 'Deniz Gezgin', 'Dennis Toddenroth', 'Denys Kaduk', 'Derek E Smith', 'Devika Subramanian', 'Dipak Kalra', 'Dirk Colaert', 'Divneet Mandair', 'Dmitry Dymshyts', 'Don Sun', 'Donahue Smith', 'Dong Ki Kim', 'Dong Kyun Park', 'DongSu Park', 'Douglas J Perkins', 'Dukyong Yoon', 'E A Vos', 'E Horvitz', 'Edeltraut Garbe', 'Edoardo Vacchi', 'Edward Burn', 'Edward Chia-Cheng Lai', 'Eimear E Kenny', 'Elias Brandt', 'Elisa Bianchini', 'Elizabeth Hanchrow', 'Elizabeth Zampino', 'Else Krajenbrink', 'Emanuele Carlini', 'Emily Welebob', 'Emmanuel Chazard', 'Eric Tchetgen Tchetgen', 'Erica A Voss', 'Eugenia Rutenberg', 'Eun Kyoung Ahn', 'Eun-Young Jung', 'Eunsil Yoon', 'Evan Minty', 'Evan T Sholle', 'Evropi Theodoratou', 'F Berger', 'F FitzHenry', 'F S Resnic', 'Fabio A Pires', 'Faraz S Ahmad', 'Fatemah A Alnofal', 'Fei Wang', 'Feichen Shen', 'Feng Cheng', 'Fernanda Polubriaginof', 'Filipa Ferreira', 'Francesco Innocenti', 'Francesco Lapi', 'Francesco Profili', 'Frank D Mentch', 'Frank J Defalco', 'Frank Manion', 'Fred Prior', 'Fredrik Nyberg', 'Fuyong Xing', 'G Honing', 'G Hripcsak', 'G Niklas Noren', 'G Trifiro', 'Gabriel A Brat', 'Gail J Roboz', 'Gary Howsam', 'Gary Meininger', 'Gavin Dabrera', 'Gayatri Amirthalingam', 'Gayo Diallo', 'George Argyriou', 'George Hripcsak', 'Giampiero Mazzaglia', 'Gianluca Trifiro', 'Gianmario Candore', 'Gilbert S Omenn', 'Gillian M Belbin', 'Gillian Smith', 'Gino Picelli', 'Giovanni Mels', 'Giulia Dal Co', 'Giuseppe Roberto', 'Gokce B Laleci Erturkmen', 'Gowtham A Rao', 'Gregoire Ficheur', 'Gregorio Coronado', 'Gregory W Hruby', 'Griffin M Weber', 'Guan N Guo', 'Guilherme Del Fiol', 'Gunther Honing', 'Guoqian Jiang', 'Gurvaneet Randhawa', 'H Storf', 'H U Prokosch', 'H W Fritsch', 'Hadi Kharrazi', 'Hafsa Bareen Syeda', 'Haini Wen', 'Hakki Kim', 'Hakon Hakonarson', 'Haleh Vatani', 'Hamed Abedtash', 'Hanlon Shau', 'Hans-Ulrich Prokosch', 'Harald Binder', 'Harald Renz', 'Harlan M Krumholz', 'Harry Campbell', 'Harry Hochheiser', 'Harshana Liyanage', 'Harshvinder Bhullar', 'Heather L Gardner', 'Heba Alghoul', 'Hee Hwang', 'Hee Young Na', 'Henning Gall', 'Henry Morgan-Stewart', 'Hermann-Josef Rothkotter', 'Himanshu Sharma', 'Hojjat Salmasian', 'Hojun Park', 'Hokyun Jeon', 'Holger Storf', 'Hong Sun', 'Hong Xu', 'Hong-Seok Lim', 'Hongbo Lin', 'Hongfang Liu', 'Howard H Chang', 'Hua Xu', 'Huawei Wu', 'Hubert Serve', 'Hunmin Kim', 'Huub Straatman', 'Huy Anh', 'Hyejin Lee', 'Hyeon-Eui Kim', 'Hyerim Ji', 'Hyung Joon Joo', 'Hyunyoung Baek', 'Iacopo Cricelli', 'Ian C K Wong', 'Ian Chi Kei Wong', 'Ian Wood', 'Iftikhar J Kullo', 'Imho Jang', 'Ines Reinecke', 'Iris Pigeot', 'Iuliana Ionita-Laza', 'J Bernarding', 'J Bonhoeffer', 'J C Denny', 'J Denton', 'J L Warner', 'J Laufer', 'J Marc Overhage', 'J Schuttler', 'J van der Lei', 'Jacqueline Yee', 'Jacques Benichou', 'Jaehyeong Cho', 'Jakob Zierk', 'James D Brooks', 'James J Cimino', 'James R Rogers', 'James Weaver', 'Jamie Lopez Bernal', 'Jan Christoph', 'Jang Wook Sohn', 'Jang-Hee Kim', 'Jason H Moore', 'Jason M Morrison', 'Jean-Baptiste Beuscart', 'Jeeyae Choi', 'Jeff Brown', 'Jeffrey G Klann', 'Jeffrey K Aronson', 'Jeffrey S Brown', 'Jenna M Reps', 'Jennifer A Pacheco', 'Jennifer C E Lane', 'Jennifer C Nelson', 'Jennifer L Williams', 'Jenny Staab', 'Jeong-Whun Kim', 'Jeongeun Seo', 'Jeongmoon Lee', 'Jeremy A Rassen', 'Jeremy L Warner', 'Jesse A Berlin', 'Jessica S Ancker', 'Jessica Tenenbaum', 'Ji-Won Kim', 'Jian Wang', 'Jianfu Li', 'Jiang Bian', 'Jianjun Guo', 'Jianxiao Yang', 'Jiayi Tong', 'Jie Xu', 'Jienchi Dorward', 'Jill Hardin', 'Jim Slattery', 'Jimeng Sun', 'Jimmy Quach', 'Jimyung Park', 'Jin Roh', 'Jingqi Wang', 'Jingsong Li', 'Jinseob Kim', 'Jitendra Jonnagaddala', 'Jiwoo Kim', 'Joan Lind', 'Joel N Swerdel', 'Joel T Dudley', 'Johan van der Lei', 'Johannes Bernarding', 'John Briggs', 'John H Holmes', 'John Parry', 'John Weeks', 'John Williams', 'Jon Duke', 'Jonathan Blaisure', 'Jonathan H Chen', 'Jonathan Leach', 'Jong Jin Yoo', 'Jong-Ho Kim', 'Jongsub Moon', 'Jordan F Karp', 'Jos De Roo', 'Jose F Rodrigues-Jr', 'Jose Luis Oliveira', 'Jose Posada', 'Joseph D Romano', 'Joseph S Ross', 'Josh Denny', 'Joshua C Denny', 'Joshua J Gagne', 'Ju Han Kim', 'Juan Gao', 'Juan M Banda', 'Juan Zhao', 'Judith A Racoosin', 'Julian Gruendner', 'Julian Sherlock', 'Jun Chen', 'Jun Li', 'Jun-Won Chung', 'Junqing Xie', 'Jurgen Hesser', 'Jurgen Schuttler', 'Justin Mower', 'Jyotishman Pathak', 'Kalyani Sonawane', 'Kandethody Ramachandran', 'Kari A Stephens', 'Karin Hedenmalm', 'Karthik Natrajan', 'Katherine D Crew', 'Kathrin Blagec', 'Kathryn J Ruddy', 'Kathryn L Colborn', 'Kavishwar B Wagholikar', 'Kayla Marie Howell', 'Kayla Quinnies', 'Kefeng Ding', 'Ken Wiley', 'Kenneth Jung', 'Kenneth K C Man', 'Keran Moll', 'Kevin B Mahoney', 'Kevin Embree', 'Kevin G Moores', 'Kevin W Sexton', 'Keywan Sohrabi', 'Ki Joong Kim', 'Kim Gates', 'Kimberly Westrich', 'Kipp W Johnson', 'Kiyoshi Kubota', 'Konrad J Karczewski', 'Kristin Kostka', 'Kristina Fister', 'Kristine E Lynch', 'Kristof Depraetere', 'Krzysztof Kiryluk', 'Kui Huang', 'Kurt Marquardt', 'Kushan Hewa', 'Kyoung Oh Kim', 'L Lang', 'L Nookala', 'L Ohno-Machado', 'Lars Pedersen', 'Laura Hester', 'Leigh-Anne Dale', 'Lemuel R Waitman', 'Lena Davidson', 'Levon Utidjian', 'Li Hou', 'Li Wang', 'Lian Lian Duan', 'Liang Yao', 'Lin Zhang', 'Lisa Bastarache', 'Lisa M Schilling', 'Liwei Wang', 'Lorenz A Kapsner', 'Lori C Phillips', 'Lu Wang', 'Luca Chiovato', 'Lucila Ohno-Machado', 'Luke V Rasmussen', 'M E Matheny', 'M J Schuemie', 'M Sedlmayr', 'M Soledad Cepeda', 'Mahanazuddin Syed', 'Man Young Park', 'Manasa Tripathy', 'Manfred Hauben', 'Manlik Kwong', 'Marc A Suchard', 'Marc Rosenman', 'Marc Twagirumukiza', 'Marcel Erpenbeck', 'Marcel de Wilde', 'Marco A Gutierrez', 'Marcus A Badgeley', 'Margaret K Pasquale', 'Margaret Sin', 'Margarita Fernandez-Chas', 'Marguerite-Marie Defebvre', 'Maria Alba', 'Maria Aragon', 'Maria Tereza F Abrahao', 'Maria Zambon', 'Mariadonata Bellentani', 'Marie-Sophie Schwalm', 'Marine Penichon', 'Mark Braunstein', 'Mark Khayter', 'Mark Levenson', 'Mark M Shervey', 'Mark R Stohr', 'Mark Thomas', 'Mark Velez', 'Martijn J Schuemie', 'Martin Boeker', 'Martin G Seneviratne', 'Martin Sedlmayr', 'Mary Regina Boland', 'Mary Simmerling', 'Maryam Garza', 'Masoud Rouhizadeh', 'Massimo Coppola', 'Matthew A H Joss', 'Matthew E Levine', 'Matthew E Spotnitz', 'Matthias Samwald', 'Matthieu Doutreligne', 'Mees Mosseveld', 'Mehr Kashyap', 'Mei Liu', 'Melanie Boerries', 'Meredith N Zozus', 'Meredith Nahm Zozus', 'Michael A Rosenberg', 'Michael E Matheny', 'Michael Feher', 'Michael G Kahn', 'Michael Gurley', 'Michael Neumaier', 'Michael Sturzl', 'Michel Dumontier', 'Michele Kummel', 'Ming Huang', 'Minh Pham', 'Miriam C J M Sturkenboom', 'Mirko Gruhl', 'Mitchell M Conover', 'Mitra Rocca', 'Modesta Visca', 'Mohammad Khoshneshin', 'Mohammed Khalilia', 'Mui Van Zandt', 'Mustafa Yuksel', 'Myung Choi', 'N H Shah', 'N P Tatonetti', 'Na Hong', 'Nadav Rappoport', 'Nan Wang', 'Nancy Roderer', 'Nansu Zong', 'Nathan P Palmer', 'Natnicha Vanitchanant', 'Naveen Ashish', 'Neil Dieterle', 'Nelson Lee', 'Nicholas Giangreco', 'Nicholas J Dobbins', 'Nicholas Jones', 'Nicholas Moore', 'Nicholas P Tatonetti', 'Nicholas Thomas', 'Nicolas Depas', 'Nicolas H Thurin', 'Nicolas Wolf', 'Nicole G Weiskopf', 'Nicole Pratt', 'Niek Klazinga', 'Nigam H Shah', 'Niklas Elmqvist', 'Nilay D Shah', 'Nils Gehlenborg', 'Ning Shang', 'Ning Zhang', 'Nir Nissim', 'Noemie Elhadad', 'Norman Rosenthal', 'Oleg Zhuk', 'Oluwafunmi Akinyemi', 'Omolola I Ogunyemi', 'Osaid Alser', 'Ozan Dikilitas', 'P E Stang', 'P Horki', 'P LePendu', 'P M Coloma', 'P R Rijnbeek', 'P Ryan', 'P Vormstein', 'Paolo Francesconi', 'Paras Mehta', 'Pascal S Brandt', 'Patricia Biedermann', 'Patricia Glowe', 'Patrick B Ryan', 'Patrick Blin', 'Patrick Fischer', 'Patrick Hosokawa', 'Patrick Wu', 'Patrizio Dazzi', 'Paul Avillach', 'Paul E Stang', 'Paul M Heider', 'Paul R Kingsbury', 'Paul Schmucker', 'Paula Casajust', 'Peggy Peissig', 'Peng Jin', 'Peng Zeng', 'Peter Arlett', 'Peter C Yang', 'Peter Greaves', 'Peter L Elkin', 'Peter R Rijnbeek', 'Peter Tarczy-Hornoch', 'Philip E Empey', 'Philip Nieri', 'Philipp Daumke', 'Philipp Unberath', 'Phillip Sippl', 'Phung-Anh Alex Nguyen', 'Phyllis M Thangaraj', 'Pierre Gentine', 'Pradipta Parhi', 'Prakash Adekkanattu', 'Praveen Kumar', 'Preciosa M Coloma', 'Premanand Tiwari', 'Qianli Ma', 'Qing Jiang', 'Qing Liu', 'Qiong Wang', 'R Bieber', 'R D Boyce', 'R Harpaz', 'R J Carroll', 'R W White', 'Rachel B Weinstein', 'Rachel Byford', 'Rae Woong Park', 'Rajesh Ranganath', 'Rami Vanguri', 'Ramkiran Gouripeddi', 'Raphael W Majeed', 'Rave Harpaz', 'Rebecca E Chandler', 'Regina T Wulff', 'Regis Lassalle', 'Remi Frazier', 'Riccardo Miotto', 'Richard A Hansen', 'Richard D Boyce', 'Richard Kiefer', 'Richard Maclin', 'Rick Larsen', 'Rimma Belenkaya', 'Rishi Saripalle', 'Ritu Khare', 'Robert A Black', 'Robert Carroll', 'Robert D Harrington', 'Robert J Caroll', 'Robert McClure', 'Robert Miller', 'Robert Moskovitch', 'Robert W Dubois', 'Roberto Berni', 'Robin E Ferner', 'Rohit Vashisht', 'Roland Croner', 'Romina Blasini', 'Ron M C Herings', 'Rong-Min Baek', 'Rosa Gini', 'Rose Qiu', 'Ross D Williams', 'Roy Pardee', 'Rui Duan', 'Rui Zhang', 'RuiJun Chen', 'Ruowang Li', 'Rupa Makadia', 'Ruth Brauer', 'Ruth Reeves', 'Ryan M Carnahan', 'S L Robbins', 'S Romio', 'S T Rosenbloom', 'S Vilar', 'S Y Zhan', 'Sajan Khosla', 'Sally C Morton', 'Salma Begum', 'Salvatore Volpe', 'Sanghyung Jin', 'Sanjay Farshid', 'Sanket S Dhruva', 'Santiago Vilar', 'Sarah Mullin', 'Sarah Seager', 'Scott L DuVall', 'Seamus Kent', 'Sean Mooney', 'Sebastian Hofer', 'Sebastian Mate', 'Seena Farzaneh', 'Seid Mussa Ahmed', 'Sejoon Lee', 'Selva Muthu Kumaran Sathappan', 'Seng Chan Yo', 'Sengwee Toh', 'Seo Jeong Shin', 'Seok Kim', 'Seokjin Haam', 'Seokyoung Song', 'Seongwon Lee', 'Sergio Fernandez-Bertolin', 'Seung In Seo', 'Seungbin Oh', 'Seungho Jeon', 'Shanshan Lu', 'Shaodian Zhang', 'Sharat Israni', 'Shaun J Grannis', 'Shawn N Murphy', 'Shaymaa Al-Shukri', 'Shenqi Jing', 'Shintaro Tsuji', 'Shinya Kimura', 'Shorabuddin Syed', 'Shreya Chakrabarti', 'Shuang Wang', 'Shuangqing Gao', 'Shumei Miao', 'Siaw-Teng Liaw', 'Sigfried Gold', 'Sijia Liu', 'Simon Lovestone', 'Simon de Lusignan', 'Simone Pinheiro', 'Siu Hui', 'Siyan Zhan', 'Sneha Iyengar', 'Soko Setoguchi', 'Sonia Araujo', 'Soo Yeon Cho', 'Sooyoung Yoo', 'Soyoung Yi', 'Spyros Kolovos', 'Stephane M Meystre', 'Stephen A Deppen', 'Stephen R Pfohl', 'Steven Bedrick', 'Steven M Handler', 'Steven Shea', 'Steven Simon', 'Stuart J Nelson', 'Suat Gonul', 'Subashan Perera', 'Sukyoung Kim', 'Sumit Mohan', 'Sun Ah Choi', 'Sundaresan Murugesan', 'Sungha Park', 'Sungjae Jung', 'Suranga N Kasthurirathne', 'Susan Gruber', 'Susan R Heckbert', 'Suzanne Bakken', 'Syed A Husain', 'Sylvester Sakilay', 'Sylvia Cho', 'T Ganslandt', 'T Herrmann', 'Tae Joon Kim', 'Tal Lorberbaum', 'Talita Duarte-Salles', 'Tao Shan', 'Terrence Adam', 'Thamir M Alshammari', 'Theodore C Goldstein', 'Theresa L Walunas', 'Thomas Falconer', 'Thomas Ganslandt', 'Thomas R Jr Campion', 'Thorsten Schwachhofer', 'Tian Kang', 'Tianshu Zhou', 'Tiffany J Callahan', 'Till Acker', 'Tim Varley', 'Timothy Miller', 'Tina M Hernandez-Boussard', 'Toan C Ong', 'Todd Lingren', 'Tony French', 'Traci Yamashita', 'Trevor Cohen', 'Usman Iqbal', 'Uy Hoang', 'Valentina Barletta', 'Valentina Tibollo', 'Victor Nwankwo', 'Victoria L Bartlett', 'Vinit P Nair', 'Virginia Rentko', 'Vitor Santos Costa', 'Vivek Rudrapatna', 'Vivian S Gainer', 'Vivienne Zhu', 'Vojtech Huser', 'W DuMouchel', 'W Nick Street', 'Walter Cazzola', 'Walter Gall', 'Wei-Qi Wei', 'Weiguo Chen', 'Weihua Gao', 'Werner Ceusters', 'William DuMouchel', 'William Hersh', 'William Hinton', 'William Victor', 'Woon Geon Shin', 'Xavier Kurz', 'Xiangrui Meng', 'Xiao Dong', 'Xiaochun Li', 'Xiaofeng Zhou', 'Xiaoliang Zhang', 'Xin Zhang', 'Xu Zuo', 'Xue Li', 'Y X Sun', 'Yanming Xie', 'Yanshan Wang', 'Yaoyun Zhang', 'Yea-Huei Kao Yang', 'Yeesuk Kim', 'Yeonsoo Hwang', 'Yerim Kim', 'Yeunsook Rho', 'Yi Zhou', 'Yihua Xu', 'Ying Li', 'Ying Wei', 'Yinghong Zhang', 'Yinying Lu', 'Yiqi Xu', 'Yixuan Guo', 'Yizhen Zhang', 'Yizhen Zhong', 'Yola Moride', 'Yong Chen', 'Yonghoon Jeon', 'Yonghua Jing', 'Yonghui Wu', 'Yoni Halpern', 'Yoon Jae Kim', 'You Sang Ko', 'Youlan Tang', 'Youn I Choi', 'Youngjun Kim', 'Yu Rang Park', 'Yu Tian', 'Yu Yang', 'Yu-Chuan Li', 'Yuan Luo', 'Yue Yu', 'Yuechuchu Yin', 'Yueshi Zhu', 'Yuhui Zou', 'Yuji Feng', 'Yujia Zhou', 'Yukari Kamijima', 'Yun Liu', 'Yuqi Si', 'Yuriy Khoma', 'Yuval Elovici', 'Yuval Shahar', 'Yuxi Tian', 'Z C Pei', 'Zach Shahn', 'Zachary H Moldwin', 'Zachary Shahn', 'Zhaobin Kuang', 'Zhe He', 'Zhenxing Xu', 'Zhong Yuan', 'Zhongmin Wang', 'Zhongqiu Huang', 'Ziran Li', 'Zuolei Dai', 'hommeaux Eri']",325,907
9,2021,"Carlen Reyes, Anastasiya Nestsiarovich, Ross D Williams, Ines Reinecke, Emanuele Girani, Antoine Lamer, Sara Khalid, Ines Reinecke, Martina Recalde, Zhehuan Chen, Vlasios K Dimitriadis, Albert Prats-Uribe, Justin T Reese, George Hripcsak, Eng Hooi Tan, Daniel Prieto-Alhambra, Jenna M Reps, Jennifer C E Lane, Nicolas H Thurin, Sooin Choi, Nicolas Paris, Miguel Pedrera, Matteo Gabetta, Yongseok Mun, Patricia Biedermann, William A Wood, Yuan Peng, Vaclav Papez, Xinhang Li, Selva Muthu Kumaran Sathappan, Clair Blacketer, Jin Ge, Joao Rafael Almeida, Christophe Gaudet-Blavignac, Ruth M Reeves, Tarun Karthik Kumar Mamidi, Junghwan Lee, Gyu Lee Kim, SeHee Oh, Raphael W Majeed, Raphael W Majeed, Eugenia Rinaldi, Fabio Boudis, Michele Zoch, Hyunah Shin, Leslie A Lenert, Byungkon Kang, Yingcheng Sun, Hao Liu, Jimyung Park, Jeong-Whun Kim, Leslie A Lenert, Hokyun Jeon, Jingqi Wang, Yeonchan Seong, Christian Maier, Rimma Belenkaya, Daniel R Morales, Seamus Kent, Edward Burn, Elizabeth T Jensen, Borim Ryu, Seung-Hwa Lee, Kyung Ae Lee, Yingcheng Sun, Elena Roel, Jin Young Yoon, Alison Callahan, Ha Il Kim, Chungsoo Kim, Ha Il Kim, Anandakumar Amutha, Christine W Hockett, Martijn J Schuemie, Jenna M Reps, Talita Duarte-Salles, Noha Sharafeldin, Tellen D Bennett, Nicholas P Giangreco, RuiJun Chen, Jean-Francois Ethier, Robert M Cronin, Xiangmin Ji, Jenna M Reps, Xintong Li, Ye Ye, Joon-Hyop Lee, Jill Hardin, Chi Yuan, Christina Schuttler, Jae Hyun Kim, Jimmy Phuong, Matthias Hunger","['Abraham G Hartzema', 'Albert Prats-Uribe', 'Alex Butler', 'Alison Callahan', 'Amelia J Averitt', 'Amy Matcho', 'Anandakumar Amutha', 'Anando Sen', 'Anastasiya Nestsiarovich', 'Andrea Haberson', 'Anil Pacaci', 'Anna Ostropolets', 'Antoine Lamer', 'Anusha Bompelli', 'Benjamin S Glicksberg', 'Benjamin Viernes', 'Borim Ryu', 'Brian E Dixon', 'Byungkon Kang', 'C Maier', 'Carlen Reyes', 'Casey N Ta', 'Chelsea L Michael', 'Chi Yuan', 'Chien-Chou Su', 'Christel Daniel', 'Christian Maier', 'Christian Reich', 'Christina Schuttler', 'Christine W Hockett', 'Christoph Rinner', 'Christophe Gaudet-Blavignac', 'Chungsoo Kim', 'Chunhua Weng', 'Clair Blacketer', 'Daniel M Lima', 'Daniel Prieto-Alhambra', 'Daniel R Morales', 'Divneet Mandair', 'Dukyong Yoon', 'E A Voss', 'Edeltraut Garbe', 'Edward Burn', 'Elena Roel', 'Elizabeth T Jensen', 'Emanuele Girani', 'Eng Hooi Tan', 'Erica A Voss', 'Eugenia Rinaldi', 'F FitzHenry', 'Fabio Boudis', 'Fatemah A Alnofal', 'Fernanda C G Polubriaginof', 'Frank J Defalco', 'G Trifiro', 'Gabriel A Brat', 'George Hripcsak', 'Gianmario Candore', 'Guan N Guo', 'Guoqian Jiang', 'Gyu Lee Kim', 'Ha Il Kim', 'Hans-Ulrich Prokosch', 'Hao Liu', 'Harshana Liyanage', 'Himanshu Sharma', 'Hokyun Jeon', 'Hong Sun', 'Hunmin Kim', 'Hyeoneui Kim', 'Hyerim Ji', 'Hyunah Shin', 'Ines Reinecke', 'Jae Hyun Kim', 'Jaehyeong Cho', 'James R Rogers', 'Jean-Francois Ethier', 'Jeffrey G Klann', 'Jenna M Reps', 'Jennifer C E Lane', 'Jeong-Whun Kim', 'Jeremy L Warner', 'Jiayi Tong', 'Jill Hardin', 'Jimmy Phuong', 'Jimyung Park', 'Jin Ge', 'Jin Young Yoon', 'Jingqi Wang', 'Joao Rafael Almeida', 'Joel N Swerdel', 'John Weeks', 'Jon D Duke', 'Jonathan C Blaisure', 'Joon-Hyop Lee', 'Juan M Banda', 'Julian Gruendner', 'Junghwan Lee', 'Justin Mower', 'Justin T Reese', 'Kristine E Lynch', 'Kyung Ae Lee', 'Lena Davidson', 'Leslie A Lenert', 'Lian Lian Duan', 'Lu Wang', 'Luke V Rasmussen', 'Manfred Hauben', 'Manlik Kwong', 'Marc A Suchard', 'Martijn J Schuemie', 'Martin G Seneviratne', 'Martina Recalde', 'Mary Regina Boland', 'Maryam Garza', 'Matteo Gabetta', 'Matthew E Levine', 'Matthew E Spotnitz', 'Matthias Samwald', 'Mehr Kashyap', 'Michele Zoch', 'Miguel Pedrera', 'Minh Pham', 'Mirko Gruhl', 'Mohammed Khalilia', 'Na Hong', 'Nicholas J Dobbins', 'Nicholas P Giangreco', 'Nicolas H Thurin', 'Nicolas Paris', 'Ning Shang', 'Nir Nissim', 'Noha Sharafeldin', 'Omolola I Ogunyemi', 'Pascal S Brandt', 'Patricia Biedermann', 'Patrick B Ryan', 'Patrick Fischer', 'Paul E Stang', 'Peter L Elkin', 'Peter R Rijnbeek', 'Philipp Unberath', 'Praveen Kumar', 'Premanand Tiwari', 'Qiong Wang', 'R Harpaz', 'R W White', 'Rachel B Weinstein', 'Rae Woong Park', 'Raphael W Majeed', 'Rebecca E Chandler', 'Richard A Hansen', 'Richard D Boyce', 'Rimma Belenkaya', 'Robert M Cronin', 'Robert Moskovitch', 'Rohit Vashisht', 'Rosa Gini', 'Ross D Williams', 'Rui Duan', 'Ruijun Chen', 'Rupa Makadia', 'Ruth Brauer', 'Ruth M Reeves', 'Ryan M Carnahan', 'S T Rosenbloom', 'S Vilar', 'Santiago Vilar', 'Sara Khalid', 'SeHee Oh', 'Seamus Kent', 'Selva Muthu Kumaran Sathappan', 'Seng Chan You', 'Seo Jeong Shin', 'Seung In Seo', 'Seung-Hwa Lee', 'Seungho Jeon', 'Shorabuddin Syed', 'Shreya Chakrabarti', 'Sigfried Gold', 'Sijia Liu', 'Simon Lovestone', 'Simon de Lusignan', 'Sooin Choi', 'Stephane M Meystre', 'Susan Gruber', 'Sylvia Cho', 'Talita Duarte-Salles', 'Tarun Karthik Kumar Mamidi', 'Tellen D Bennett', 'Tian Kang', 'Tiffany J Callahan', 'Toan C Ong', 'Vaclav Papez', 'Victoria L Bartlett', 'Vlasios K Dimitriadis', 'Vojtech Huser', 'Werner Ceusters', 'William A Wood', 'Xiangmin Ji', 'Xiaochun Li', 'Xiaofeng Zhou', 'Xin Zhang', 'Xinhang Li', 'Xintong Li', 'Xu Zuo', 'Y X Sun', 'Ye Ye', 'Yeesuk Kim', 'Yeonchan Seong', 'Yihua Xu', 'Ying Li', 'Yingcheng Sun', 'Yongseok Mun', 'Youn I Choi', 'Yu Tian', 'Yu Yang', 'Yuan Peng', 'Yue Yu', 'Yuqi Si', 'Zhaobin Kuang', 'Zhehuan Chen', 'Zhong Yuan', 'nan']",71,224,"['Carlen, Reyes', 'Andrea, Pistillo', 'Sergio, Fernandez-Bertolin', 'Martina, Recalde', 'Elena, Roel', 'Diana, Puente', 'Anthony G, Sena', 'Clair, Blacketer', 'Lana, Lai', 'Thamir M, Alshammari', 'Waheed-Ui-Rahman, Ahmed', 'Osaid, Alser', 'Heba, Alghoul', 'Carlos, Areia', 'Dalia, Dawoud', 'Albert, Prats-Uribe', 'Neus, Valveny', 'Gabriel, de Maeztu', 'Luisa, Sorli Redo', 'Jordi, Martinez Roldan', 'Inmaculada, Lopez Montesinos', 'Lisa M, Schilling', 'Asieh, Golozar', 'Christian, Reich', 'Jose D, Posada', 'Nigam, Shah', 'Seng Chan, You', 'Kristine E, Lynch', 'Scott L, DuVall', 'Michael E, Matheny', 'Fredrik, Nyberg', 'Anna, Ostropolets', 'George, Hripcsak', 'Peter R, Rijnbeek', 'Marc A, Suchard', 'Patrick, Ryan', 'Kristin, Kostka', 'Talita, Duarte-Salles'], ['Anastasiya, Nestsiarovich', 'Jenna M, Reps', 'Michael E, Matheny', 'Scott L, DuVall', 'Kristine E, Lynch', 'Maura, Beaton', 'Xinzhuo, Jiang', 'Matthew, Spotnitz', 'Stephen R, Pfohl', 'Nigam H, Shah', 'Carmen Olga, Torre', 'Christian G, Reich', 'Dong Yun, Lee', 'Sang Joon, Son', 'Seng Chan, You', 'Rae Woong, Park', 'Patrick B, Ryan', 'Christophe G, Lambert'], ['Ross D, Williams', 'Jenna M, Reps', 'Peter R, Rijnbeek', 'Patrick B, Ryan', 'Daniel, Prieto-Alhambra'], ['Ines, Reinecke', 'Michele, Zoch', 'Markus, Wilhelm', 'Martin, Sedlmayr', 'Franziska, Bathelt'], ['Emanuele, Girani', 'Matteo, Gabetta', 'Anna, Alloni', 'Morena, Stuppia', 'Lucia, Sacchi', 'Nicola, Barbarini'], ['Antoine, Lamer', 'Osama, Abou-Arab', 'Alexandre, Bourgeois', 'Adrien, Parrot', 'Benjamin, Popoff', 'Jean-Baptiste, Beuscart', 'Benoit, Tavernier', 'Mouhamed Djahoum, Moussa'], ['Sara, Khalid', 'Cynthia, Yang', 'Clair, Blacketer', 'Talita, Duarte-Salles', 'Sergio, Fernandez-Bertolin', 'Chungsoo, Kim', 'Rae Woong, Park', 'Jimyung, Park', 'Martijn J, Schuemie', 'Anthony G, Sena', 'Marc A, Suchard', 'Seng Chan, You', 'Peter R, Rijnbeek', 'Jenna M, Reps'], ['Ines, Reinecke', 'Michele, Zoch', 'Christian, Reich', 'Martin, Sedlmayr', 'Franziska, Bathelt'], ['Martina, Recalde', 'Elena, Roel', 'Andrea, Pistillo', 'Anthony G, Sena', 'Albert, Prats-Uribe', 'Waheed-Ul-Rahman, Ahmed', 'Heba, Alghoul', 'Thamir M, Alshammari', 'Osaid, Alser', 'Carlos, Areia', 'Edward, Burn', 'Paula, Casajust', 'Dalia, Dawoud', 'Scott L, DuVall', 'Thomas, Falconer', 'Sergio, Fernandez-Bertolin', 'Asieh, Golozar', 'Mengchun, Gong', 'Lana Yin Hui, Lai', 'Jennifer C E, Lane', 'Kristine E, Lynch', 'Michael E, Matheny', 'Paras P, Mehta', 'Daniel R, Morales', 'Karthik, Natarjan', 'Fredrik, Nyberg', 'Jose D, Posada', 'Christian G, Reich', 'Peter R, Rijnbeek', 'Lisa M, Schilling', 'Karishma, Shah', 'Nigam H, Shah', 'Vignesh, Subbian', 'Lin, Zhang', 'Hong, Zhu', 'Patrick, Ryan', 'Daniel, Prieto-Alhambra', 'Kristin, Kostka', 'Talita, Duarte-Salles'], ['Zhehuan, Chen', 'Hao, Liu', 'Alex, Butler', 'Anna, Ostropolets', 'Chunhua, Weng'], ['Vlasios K, Dimitriadis', 'George I, Gavriilidis', 'Pantelis, Natsiavas'], ['Albert, Prats-Uribe', 'Anthony G, Sena', 'Lana Yin Hui, Lai', 'Waheed-Ul-Rahman, Ahmed', 'Heba, Alghoul', 'Osaid, Alser', 'Thamir M, Alshammari', 'Carlos, Areia', 'William, Carter', 'Paula, Casajust', 'Dalia, Dawoud', 'Asieh, Golozar', 'Jitendra, Jonnagaddala', 'Paras P, Mehta', 'Mengchun, Gong', 'Daniel R, Morales', 'Fredrik, Nyberg', 'Jose D, Posada', 'Martina, Recalde', 'Elena, Roel', 'Karishma, Shah', 'Nigam H, Shah', 'Lisa M, Schilling', 'Vignesh, Subbian', 'David, Vizcaya', 'Lin, Zhang', 'Ying, Zhang', 'Hong, Zhu', 'Li, Liu', 'Jaehyeong, Cho', 'Kristine E, Lynch', 'Michael E, Matheny', 'Seng Chan, You', 'Peter R, Rijnbeek', 'George, Hripcsak', 'Jennifer Ce, Lane', 'Edward, Burn', 'Christian, Reich', 'Marc A, Suchard', 'Talita, Duarte-Salles', 'Kristin, Kostka', 'Patrick B, Ryan', 'Daniel, Prieto-Alhambra'], ['Justin T, Reese', 'Ben, Coleman', 'Lauren, Chan', 'Hannah, Blau', 'Tiffany J, Callahan', 'Luca, Cappelletti', 'Tommaso, Fontana', 'Katie Rebecca, Bradwell', 'Nomi L, Harris', 'Elena, Casiraghi', 'Giorgio, Valentini', 'Guy, Karlebach', 'Rachel, Deer', 'Julie A, McMurry', 'Melissa A, Haendel', 'Christopher G, Chute', 'Emily, Pfaff', 'Richard, Moffitt', 'Heidi, Spratt', 'Jasvinder, Singh', 'Christopher J, Mungall', 'Andrew E, Williams', 'Peter N, Robinson'], ['George, Hripcsak', 'Martijn J, Schuemie', 'David, Madigan', 'Patrick B, Ryan', 'Marc A, Suchard'], ['Eng Hooi, Tan', 'Anthony G, Sena', 'Albert, Prats-Uribe', 'Seng Chan, You', 'Waheed-Ul-Rahman, Ahmed', 'Kristin, Kostka', 'Christian, Reich', 'Scott L, Duvall', 'Kristine E, Lynch', 'Michael E, Matheny', 'Talita, Duarte-Salles', 'Sergio Fernandez, Bertolin', 'George, Hripcsak', 'Karthik, Natarajan', 'Thomas, Falconer', 'Matthew, Spotnitz', 'Anna, Ostropolets', 'Clair, Blacketer', 'Thamir M, Alshammari', 'Heba, Alghoul', 'Osaid, Alser', 'Jennifer C E, Lane', 'Dalia M, Dawoud', 'Karishma, Shah', 'Yue, Yang', 'Lin, Zhang', 'Carlos, Areia', 'Asieh, Golozar', 'Martina, Recalde', 'Paula, Casajust', 'Jitendra, Jonnagaddala', 'Vignesh, Subbian', 'David, Vizcaya', 'Lana Y H, Lai', 'Fredrik, Nyberg', 'Daniel R, Morales', 'Jose D, Posada', 'Nigam H, Shah', 'Mengchun, Gong', 'Arani, Vivekanantham', 'Aaron, Abend', 'Evan P, Minty', 'Marc, Suchard', 'Peter, Rijnbeek', 'Patrick B, Ryan', 'Daniel, Prieto-Alhambra'], ['Daniel, Prieto-Alhambra', 'Kristin, Kostka', 'Talita, Duarte-Salles', 'Albert, Prats-Uribe', 'Anthony, Sena', 'Andrea, Pistillo', 'Sara, Khalid', 'Lana, Lai', 'Asieh, Golozar', 'Thamir M, Alshammari', 'Dalia, Dawoud', 'Fredrik, Nyberg', 'Adam, Wilcox', 'Alan, Andryc', 'Andrew, Williams', 'Anna, Ostropolets', 'Carlos, Areia', 'Chi Young, Jung', 'Christopher, Harle', 'Christian, Reich', 'Clair, Blacketer', 'Daniel, Morales', 'David A, Dorr', 'Edward, Burn', 'Elena, Roel', 'Eng Hooi, Tan', 'Evan, Minty', 'Frank, DeFalco', 'Gabriel, de Maeztu', 'Gigi, Lipori', 'Heba, Alghoul', 'Hong, Zhu', 'Jason, Thomas', 'Jiang, Bian', 'Jimyung, Park', 'Jordi Martinez, Roldan', 'Jose, Posada', 'Juan M, Banda', 'Juan P, Horcajada', 'Julianna, Kohler', 'Karishma, Shah', 'Karthik, Natarajan', 'Kristine, Lynch', 'Li, Liu', 'Lisa, Schilling', 'Martina, Recalde', 'Matthew, Spotnitz', 'Mengchun, Gong', 'Michael, Matheny', 'Neus, Valveny', 'Nicole, Weiskopf', 'Nigam, Shah', 'Osaid, Alser', 'Paula, Casajust', 'Rae Woong, Park', 'Robert, Schuff', 'Sarah, Seager', 'Scott, DuVall', 'Seng Chan, You', 'Seokyoung, Song', 'Sergio, Fernandez-Bertolin', 'Stephen, Fortin', 'Tanja, Magoc', 'Thomas, Falconer', 'Vignesh, Subbian', 'Vojtech, Huser', 'Waheed-Ul-Rahman, Ahmed', 'William, Carter', 'Yin, Guan', 'Yankuic, Galvan', 'Xing, He', 'Peter, Rijnbeek', 'George, Hripcsak', 'Patrick, Ryan', 'Marc, Suchard'], ['Jenna M, Reps', 'Chungsoo, Kim', 'Ross D, Williams', 'Aniek F, Markus', 'Cynthia, Yang', 'Talita, Duarte-Salles', 'Thomas, Falconer', 'Jitendra, Jonnagaddala', 'Andrew, Williams', 'Sergio, Fernandez-Bertolin', 'Scott L, DuVall', 'Kristin, Kostka', 'Gowtham, Rao', 'Azza, Shoaibi', 'Anna, Ostropolets', 'Matthew E, Spotnitz', 'Lin, Zhang', 'Paula, Casajust', 'Ewout W, Steyerberg', 'Fredrik, Nyberg', 'Benjamin Skov, Kaas-Hansen', 'Young Hwa, Choi', 'Daniel, Morales', 'Siaw-Teng, Liaw', 'Maria Tereza Fernandes, Abrahao', 'Carlos, Areia', 'Michael E, Matheny', 'Kristine E, Lynch', 'Maria, Aragon', 'Rae Woong, Park', 'George, Hripcsak', 'Christian G, Reich', 'Marc A, Suchard', 'Seng Chan, You', 'Patrick B, Ryan', 'Daniel, Prieto-Alhambra', 'Peter R, Rijnbeek'], ['Jennifer C E, Lane', 'James, Weaver', 'Kristin, Kostka', 'Talita, Duarte-Salles', 'Maria Tereza F, Abrahao', 'Heba, Alghoul', 'Osaid, Alser', 'Thamir M, Alshammari', 'Carlos, Areia', 'Patricia, Biedermann', 'Juan M, Banda', 'Edward, Burn', 'Paula, Casajust', 'Kristina, Fister', 'Jill, Hardin', 'Laura, Hester', 'George, Hripcsak', 'Benjamin Skov, Kaas-Hansen', 'Sajan, Khosla', 'Spyros, Kolovos', 'Kristine E, Lynch', 'Rupa, Makadia', 'Paras P, Mehta', 'Daniel R, Morales', 'Henry, Morgan-Stewart', 'Mees, Mosseveld', 'Danielle, Newby', 'Fredrik, Nyberg', 'Anna, Ostropolets', 'Rae, Woong Park', 'Albert, Prats-Uribe', 'Gowtham A, Rao', 'Christian, Reich', 'Peter, Rijnbeek', 'Anthony G, Sena', 'Azza, Shoaibi', 'Matthew, Spotnitz', 'Vignesh, Subbian', 'Marc A, Suchard', 'David, Vizcaya', 'Haini, Wen', 'Marcel de, Wilde', 'Junqing, Xie', 'Seng Chan, You', 'Lin, Zhang', 'Simon, Lovestone', 'Patrick, Ryan', 'Daniel, Prieto-Alhambra'], ['Nicolas H, Thurin', 'Regis, Lassalle', 'Martijn, Schuemie', 'Marine, Penichon', 'Joshua J, Gagne', 'Jeremy A, Rassen', 'Jacques, Benichou', 'Alain, Weill', 'Patrick, Blin', 'Nicholas, Moore', 'Cecile, Droz-Perroteau'], ['Sooin, Choi', 'Soo Jeong, Choi', 'Jin Kuk, Kim', 'Ki Chang, Nam', 'Suehyun, Lee', 'Ju Han, Kim', 'You Kyoung, Lee'], ['Nicolas, Paris', 'Antoine, Lamer', 'Adrien, Parrot'], ['Miguel, Pedrera', 'Noelia, Garcia', 'Paula, Rubio', 'Juan Luis, Cruz', 'Jose Luis, Bernal', 'Pablo, Serrano'], ['Matteo, Gabetta', 'Anna, Alloni', 'Francesca, Polce', 'Giordano, Lanzola', 'Enea, Parimbelli', 'Nicola, Barbarini'], ['Yongseok, Mun', 'Seng Chan, You', 'Da Yun, Lee', 'Seok, Kim', 'Yoo-Ri, Chung', 'Kihwang, Lee', 'Ji Hun, Song', 'Young Gun, Park', 'Young Hoon, Park', 'Young-Jung, Roh', 'Se Joon, Woo', 'Kyu Hyung, Park', 'Rae Woong, Park', 'Sooyoung, Yoo', 'Dong-Jin, Chang', 'Sang Jun, Park'], ['Patricia, Biedermann', 'Rose, Ong', 'Alexander, Davydov', 'Alexandra, Orlova', 'Philip, Solovyev', 'Hong, Sun', 'Graham, Wetherill', 'Monika, Brand', 'Eva-Maria, Didden'], ['William A, Wood', 'Peter, Marks', 'Robert M, Plovnick', 'Kathleen, Hewitt', 'Donna S, Neuberg', 'Sam, Walters', 'Brendan K, Dolan', 'Emily A, Tucker', 'Charles S, Abrams', 'Alexis A, Thompson', 'Kenneth C, Anderson', 'Paul, Kluetz', 'Ann, Farrell', 'Donna, Rivera', 'Matthew, Gertzog', 'Gregory, Pappas'], ['Yuan, Peng', 'Azadeh, Nassirian', 'Najia, Ahmadi', 'Martin, Sedlmayr', 'Franziska, Bathelt'], ['Vaclav, Papez', 'Maxim, Moinat', 'Stefan, Payralbe', 'Folkert W, Asselbergs', 'R Thomas, Lumbers', 'Harry, Hemingway', 'Richard, Dobson', 'Spiros, Denaxas'], ['Xinhang, Li', 'Hao, Liu', 'Fabricio, Kury', 'Chi, Yuan', 'Alex, Butler', 'Yingcheng, Sun', 'Anna, Ostropolets', 'Hua, Xu', 'Chunhua, Weng'], ['Selva Muthu Kumaran, Sathappan', 'Young Seok, Jeon', 'Trung Kien, Dang', 'Su Chi, Lim', 'Yi-Ming, Shao', 'E Shyong, Tai', 'Mengling, Feng'], ['Clair, Blacketer', 'Frank J, Defalco', 'Patrick B, Ryan', 'Peter R, Rijnbeek'], ['Jin, Ge', 'Mark J, Pletcher', 'Jennifer C, Lai'], ['Joao Rafael, Almeida', 'Joao Figueira, Silva', 'Sergio, Matos', 'Jose Luis, Oliveira'], ['Christophe, Gaudet-Blavignac', 'Jean Louis, Raisaro', 'Vasundra, Toure', 'Sabine, Osterle', 'Katrin, Crameri', 'Christian, Lovis'], ['Ruth M, Reeves', 'Lee, Christensen', 'Jeremiah R, Brown', 'Michael, Conway', 'Maxwell, Levis', 'Glenn T, Gobbel', 'Rashmee U, Shah', 'Christine, Goodrich', 'Iben, Ricket', 'Freneka, Minter', 'Andrew, Bohm', 'Bruce E, Bray', 'Michael E, Matheny', 'Wendy, Chapman'], ['Tarun Karthik Kumar, Mamidi', 'Thi K, Tran-Nguyen', 'Ryan L, Melvin', 'Elizabeth A, Worthey'], ['Junghwan, Lee', 'Cong, Liu', 'Jae Hyun, Kim', 'Alex, Butler', 'Ning, Shang', 'Chao, Pang', 'Karthik, Natarajan', 'Patrick, Ryan', 'Casey, Ta', 'Chunhua, Weng'], ['Gyu Lee, Kim', 'Yu Hyeon, Yi', 'Hye Rim, Hwang', 'Jinmi, Kim', 'Youngmin, Park', 'Yun Jin, Kim', 'Jeong Gyu, Lee', 'Young Jin, Tak', 'Seung Hun, Lee', 'Sang Yeoup, Lee', 'Youn Hye, Cho', 'Eun Ju, Park', 'Youngin, Lee'], ['SeHee, Oh', 'MinDong, Sung', 'Yumie, Rhee', 'Namki, Hong', 'Yu Rang, Park'], ['Raphael W, Majeed', 'Patrick, Fischer', 'Andreas, Gunther'], ['Raphael W, Majeed', 'Mark R, Stohr', 'Andreas, Gunther'], ['Eugenia, Rinaldi', 'Sylvia, Thun'], ['Fabio, Boudis', 'Guillaume, Clement', 'Amelie, Bruandet', 'Antoine, Lamer'], ['Michele, Zoch', 'Christian, Gierschner', 'Yuan, Peng', 'Mirko, Gruhl', 'Liz A, Leutner', 'Martin, Sedlmayr', 'Franziska, Bathelt'], ['Hyunah, Shin', 'Suehyun, Lee'], ['Leslie A, Lenert', 'Andrey V, Ilatovskiy', 'James, Agnew', 'Patricia, Rudisill', 'Jeff, Jacobs', 'Duncan, Weatherston', 'Kenneth R Jr, Deans'], ['Byungkon, Kang', 'Jisang, Yoon', 'Ha Young, Kim', 'Sung Jin, Jo', 'Yourim, Lee', 'Hye Jin, Kam'], ['Yingcheng, Sun', 'Alex, Butler', 'Latoya A, Stewart', 'Hao, Liu', 'Chi, Yuan', 'Christopher T, Southard', 'Jae Hyun, Kim', 'Chunhua, Weng'], ['Hao, Liu', 'Yuan, Chi', 'Alex, Butler', 'Yingcheng, Sun', 'Chunhua, Weng'], ['Jimyung, Park', 'Seng Chan, You', 'Eugene, Jeong', 'Chunhua, Weng', 'Dongsu, Park', 'Jin, Roh', 'Dong Yun, Lee', 'Jae Youn, Cheong', 'Jin Wook, Choi', 'Mira, Kang', 'Rae Woong, Park'], ['Jeong-Whun, Kim', 'Seok, Kim', 'Borim, Ryu', 'Wongeun, Song', 'Ho-Young, Lee', 'Sooyoung, Yoo'], ['Leslie A, Lenert', 'Andrey V, Ilatovskiy', 'James, Agnew', 'Patricia, Rudsill', 'Jeff, Jacobs', 'Duncan, Weatherston', 'Kenneth, Deans'], ['Hokyun, Jeon', 'Seng Chan, You', 'Seok Yun, Kang', 'Seung In, Seo', 'Jeremy L, Warner', 'Rimma, Belenkaya', 'Rae Woong, Park'], ['Jingqi, Wang', 'Noor, Abu-El-Rub', 'Josh, Gray', 'Huy Anh, Pham', 'Yujia, Zhou', 'Frank J, Manion', 'Mei, Liu', 'Xing, Song', 'Hua, Xu', 'Masoud, Rouhizadeh', 'Yaoyun, Zhang'], ['Yeonchan, Seong', 'Seng Chan, You', 'Anna, Ostropolets', 'Yeunsook, Rho', 'Jimyung, Park', 'Jaehyeong, Cho', 'Dmitry, Dymshyts', 'Christian G, Reich', 'Yunjung, Heo', 'Rae Woong, Park'], ['Christian, Maier', 'Lorenz A, Kapsner', 'Sebastian, Mate', 'Hans-Ulrich, Prokosch', 'Stefan, Kraus'], ['Rimma, Belenkaya', 'Michael J, Gurley', 'Asieh, Golozar', 'Dmitry, Dymshyts', 'Robert T, Miller', 'Andrew E, Williams', 'Shilpa, Ratwani', 'Anastasios, Siapos', 'Vladislav, Korsik', 'Jeremy, Warner', 'W Scott, Campbell', 'Donna, Rivera', 'Tatiana, Banokina', 'Elizaveta, Modina', 'Shantha, Bethusamy', 'Henry Morgan, Stewart', 'Meera, Patel', 'Ruijun, Chen', 'Thomas, Falconer', 'Rae Woong, Park', 'Seng Chan, You', 'Hokyun, Jeon', 'Soe Jeong, Shin', 'Christian, Reich'], ['Daniel R, Morales', 'Mitchell M, Conover', 'Seng Chan, You', 'Nicole, Pratt', 'Kristin, Kostka', 'Talita, Duarte-Salles', 'Sergio, Fernandez-Bertolin', 'Maria, Aragon', 'Scott L, DuVall', 'Kristine, Lynch', 'Thomas, Falconer', 'Kees, van Bochove', 'Cynthia, Sung', 'Michael E, Matheny', 'Christophe G, Lambert', 'Fredrik, Nyberg', 'Thamir M, Alshammari', 'Andrew E, Williams', 'Rae Woong, Park', 'James, Weaver', 'Anthony G, Sena', 'Martijn J, Schuemie', 'Peter R, Rijnbeek', 'Ross D, Williams', 'Jennifer C E, Lane', 'Albert, Prats-Uribe', 'Lin, Zhang', 'Carlos, Areia', 'Harlan M, Krumholz', 'Daniel, Prieto-Alhambra', 'Patrick B, Ryan', 'George, Hripcsak', 'Marc A, Suchard'], ['Seamus, Kent', 'Edward, Burn', 'Dalia, Dawoud', 'Pall, Jonsson', 'Jens Torup, Ostby', 'Nigel, Hughes', 'Peter, Rijnbeek', 'Jacoline C, Bouvy'], ['Edward, Burn', 'Anthony G, Sena', 'Albert, Prats-Uribe', 'Matthew, Spotnitz', 'Scott, DuVall', 'Kristine E, Lynch', 'Michael E, Matheny', 'Fredrik, Nyberg', 'Waheed-Ul-Rahman, Ahmed', 'Osaid, Alser', 'Heba, Alghoul', 'Thamir, Alshammari', 'Lin, Zhang', 'Paula, Casajust', 'Carlos, Areia', 'Karishma, Shah', 'Christian, Reich', 'Clair, Blacketer', 'Alan, Andryc', 'Stephen, Fortin', 'Karthik, Natarajan', 'Mengchun, Gong', 'Asieh, Golozar', 'Daniel, Morales', 'Peter, Rijnbeek', 'Vignesh, Subbian', 'Elena, Roel', 'Martina, Recalde', 'Jennifer C E, Lane', 'David, Vizcaya', 'Jose D, Posada', 'Nigam H, Shah', 'Jitendra, Jonnagaddala', 'Lana Yin Hui, Lai', 'Francesc Xavier, Aviles-Jurado', 'George, Hripcsak', 'Marc A, Suchard', 'Otavio T, Ranzani', 'Patrick, Ryan', 'Daniel, Prieto-Alhambra', 'Kristin, Kostka', 'Talita, Duarte-Salles'], ['Elizabeth T, Jensen', 'Dana A, Dabelea', 'Pradeep A, Praveen', 'Anandakumar, Amutha', 'Christine W, Hockett', 'Scott P, Isom', 'Toan C, Ong', 'Viswanathan, Mohan', ', Agostino, Ralph Jr""', ', ', ', ', ', ', ', ', ', ', ', ', ', ', ', ', ', ', ], ['Borim, Ryu', 'Sooyoung, Yoo', 'Seok, Kim', 'Jinwook, Choi'], ['Seung-Hwa, Lee', 'Kwang Jin, Chun', 'Jungchan, Park', 'Jinseob, Kim', 'Ji Dong, Sung', 'Rae Woong, Park', 'Jinwook, Choi', 'Kwangmo, Yang'], ['Kyung Ae, Lee', 'Heung Yong, Jin', 'Yu Ji, Kim', 'Yong-Jin, Im', 'Eun-Young, Kim', 'Tae Sun, Park'], ['Yingcheng, Sun', 'Alex, Butler', 'Ibrahim, Diallo', 'Jae Hyun, Kim', 'Casey, Ta', 'James R, Rogers', 'Hao, Liu', 'Chunhua, Weng'], ['Elena, Roel', 'Andrea, Pistillo', 'Martina, Recalde', 'Anthony G, Sena', 'Sergio, Fernandez-Bertolin', 'Maria, Aragon', 'Diana, Puente', 'Waheed-Ul-Rahman, Ahmed', 'Heba, Alghoul', 'Osaid, Alser', 'Thamir M, Alshammari', 'Carlos, Areia', 'Clair, Blacketer', 'William, Carter', 'Paula, Casajust', 'Aedin C, Culhane', 'Dalia, Dawoud', 'Frank, DeFalco', 'Scott L, DuVall', 'Thomas, Falconer', 'Asieh, Golozar', 'Mengchun, Gong', 'Laura, Hester', 'George, Hripcsak', 'Eng Hooi, Tan', 'Hokyun, Jeon', 'Jitendra, Jonnagaddala', 'Lana Y H, Lai', 'Kristine E, Lynch', 'Michael E, Matheny', 'Daniel R, Morales', 'Karthik, Natarajan', 'Fredrik, Nyberg', 'Anna, Ostropolets', 'Jose D, Posada', 'Albert, Prats-Uribe', 'Christian G, Reich', 'Donna R, Rivera', 'Lisa M, Schilling', 'Isabelle, Soerjomataram', 'Karishma, Shah', 'Nigam H, Shah', 'Yang, Shen', 'Matthew, Spotniz', 'Vignesh, Subbian', 'Marc A, Suchard', 'Annalisa, Trama', 'Lin, Zhang', 'Ying, Zhang', 'Patrick B, Ryan', 'Daniel, Prieto-Alhambra', 'Kristin, Kostka', 'Talita, Duarte-Salles'], ['Jin Young, Yoon', 'Jae Myung, Cha', 'Ha Il, Kim', 'Min Seob, Kwak'], ['Alison, Callahan', 'Vladimir, Polony', 'Jose D, Posada', 'Juan M, Banda', 'Saurabh, Gombar', 'Nigam H, Shah'], ['Ha Il, Kim', 'Jin Young, Yoon', 'Min Seob, Kwak', 'Jae Myung, Cha'], ['Chungsoo, Kim', 'Seng Chan, You', 'Jenna M, Reps', 'Jae Youn, Cheong', 'Rae Woong, Park'], ['Ha Il, Kim', 'Jin Young, Yoon', 'Min Seob, Kwak', 'Jae Myung, Cha'], ['Anandakumar, Amutha', 'Pradeep A, Praveen', 'Christine W, Hockett', 'Toan C, Ong', 'Elizabeth T, Jensen', 'Scott P, Isom', ', Agostino, Ralph B Jr""', ', ', ', ', ', ', ', ', ', ', ', ', ', ', ', ', ], ['Christine W, Hockett', 'Pradeep A, Praveen', 'Toan C, Ong', 'Anandakumar, Amutha', 'Scott P, Isom', 'Elizabeth T, Jensen', ', Agostino, Ralph B Jr""', ', ', ', ', ', ', ', ', ', ', ', ', ', ', ], ['Martijn J, Schuemie', 'Patrick B, Ryan', 'Nicole, Pratt', 'RuiJun, Chen', 'Seng Chan, You', 'Harlan M, Krumholz', 'David, Madigan', 'George, Hripcsak', 'Marc A, Suchard'], ['Jenna M, Reps', 'Peter, Rijnbeek', 'Alana, Cuthbert', 'Patrick B, Ryan', 'Nicole, Pratt', 'Martijn, Schuemie'], ['Talita, Duarte-Salles', 'David, Vizcaya', 'Andrea, Pistillo', 'Paula, Casajust', 'Anthony G, Sena', 'Lana Yin Hui, Lai', 'Albert, Prats-Uribe', 'Waheed-Ul-Rahman, Ahmed', 'Thamir M, Alshammari', 'Heba, Alghoul', 'Osaid, Alser', 'Edward, Burn', 'Seng Chan, You', 'Carlos, Areia', 'Clair, Blacketer', 'Scott, DuVall', 'Thomas, Falconer', 'Sergio, Fernandez-Bertolin', 'Stephen, Fortin', 'Asieh, Golozar', 'Mengchun, Gong', 'Eng Hooi, Tan', 'Vojtech, Huser', 'Pablo, Iveli', 'Daniel R, Morales', 'Fredrik, Nyberg', 'Jose D, Posada', 'Martina, Recalde', 'Elena, Roel', 'Lisa M, Schilling', 'Nigam H, Shah', 'Karishma, Shah', 'Marc A, Suchard', 'Lin, Zhang', 'Ying, Zhang', 'Andrew E, Williams', 'Christian G, Reich', 'George, Hripcsak', 'Peter, Rijnbeek', 'Patrick, Ryan', 'Kristin, Kostka', 'Daniel, Prieto-Alhambra'], ['Noha, Sharafeldin', 'Benjamin, Bates', 'Qianqian, Song', 'Vithal, Madhira', 'Yao, Yan', 'Sharlene, Dong', 'Eileen, Lee', 'Nathaniel, Kuhrt', 'Yu Raymond, Shao', 'Feifan, Liu', 'Timothy, Bergquist', 'Justin, Guinney', 'Jing, Su', 'Umit, Topaloglu'], ['Tellen D, Bennett', 'Richard A, Moffitt', 'Janos G, Hajagos', 'Benjamin, Amor', 'Adit, Anand', 'Mark M, Bissell', 'Katie Rebecca, Bradwell', 'Carolyn, Bremer', 'James Brian, Byrd', 'Alina, Denham', 'Peter E, DeWitt', 'Davera, Gabriel', 'Brian T, Garibaldi', 'Andrew T, Girvin', 'Justin, Guinney', 'Elaine L, Hill', 'Stephanie S, Hong', 'Hunter, Jimenez', 'Ramakanth, Kavuluru', 'Kristin, Kostka', 'Harold P, Lehmann', 'Eli, Levitt', 'Sandeep K, Mallipattu', 'Amin, Manna', 'Julie A, McMurry', 'Michele, Morris', 'John, Muschelli', 'Andrew J, Neumann', 'Matvey B, Palchuk', 'Emily R, Pfaff', 'Zhenglong, Qian', 'Nabeel, Qureshi', 'Seth, Russell', 'Heidi, Spratt', 'Anita, Walden', 'Andrew E, Williams', 'Jacob T, Wooldridge', 'Yun Jae, Yoo', 'Xiaohan Tanner, Zhang', 'Richard L, Zhu', 'Christopher P, Austin', 'Joel H, Saltz', 'Ken R, Gersing', 'Melissa A, Haendel', 'Christopher G, Chute'], ['Nicholas P, Giangreco', 'Nicholas P, Tatonetti'], ['RuiJun, Chen', 'Marc A, Suchard', 'Harlan M, Krumholz', 'Martijn J, Schuemie', 'Steven, Shea', 'Jon, Duke', 'Nicole, Pratt', 'Christian G, Reich', 'David, Madigan', 'Seng Chan, You', 'Patrick B, Ryan', 'George, Hripcsak'], ['Jean-Francois, Ethier', 'Francois, Goyer', 'Paul, Fabry', 'Adrien, Barton'], ['Robert M, Cronin', 'Alese E, Halvorson', 'Cassie, Springer', 'Xiaoke, Feng', 'Lina, Sulieman', 'Roxana, Loperena-Cortes', 'Kelsey, Mayo', 'Robert J, Carroll', 'Qingxia, Chen', 'Brian K, Ahmedani', 'Jason, Karnes', 'Bruce, Korf', ', Donnell, Christopher J""', ', ', ], ['Xiangmin, Ji', 'Guimei, Cui', 'Chengzhen, Xu', 'Jie, Hou', 'Yunfei, Zhang', 'Yan, Ren'], ['Jenna M, Reps', 'Patrick, Ryan', 'P R, Rijnbeek'], ['Xintong, Li', 'Lana Yh, Lai', 'Anna, Ostropolets', 'Faaizah, Arshad', 'Eng Hooi, Tan', 'Paula, Casajust', 'Thamir M, Alshammari', 'Talita, Duarte-Salles', 'Evan P, Minty', 'Carlos, Areia', 'Nicole, Pratt', 'Patrick B, Ryan', 'George, Hripcsak', 'Marc A, Suchard', 'Martijn J, Schuemie', 'Daniel, Prieto-Alhambra'], ['Ye, Ye', 'Seemran, Barapatre', 'Michael K, Davis', 'Keith O, Elliston', 'Christos, Davatzikos', 'Andrey, Fedorov', 'Jean-Christophe, Fillion-Robin', 'Ian, Foster', 'John R, Gilbertson', 'Andras, Lasso', 'James V, Miller', 'Martin, Morgan', 'Steve, Pieper', 'Brigitte E, Raumann', 'Brion D, Sarachan', 'Guergana, Savova', 'Jonathan C, Silverstein', 'Donald P, Taylor', 'Joyce B, Zelnis', 'Guo-Qiang, Zhang', 'Jamie, Cuticchia', 'Michael J, Becich'], ['Joon-Hyop, Lee', 'Suhyun, Kim', 'Kwangsoo, Kim', 'Young Jun, Chai', 'Hyeong Won, Yu', 'Su-Jin, Kim', 'June Young, Choi', 'Yoo Seung, Chung', 'Kyu Eun, Lee', 'Ka Hee, Yi'], ['Jill, Hardin', 'Jenna M, Reps'], ['Chi, Yuan', 'Patrick B, Ryan', 'Casey N, Ta', 'Jae Hyun, Kim', 'Ziran, Li', 'Chunhua, Weng'], ['Christina, Schuttler', 'Hans-Ulrich, Prokosch', 'Martin, Sedlmayr', 'Brita, Sedlmayr'], ['Jae Hyun, Kim', 'Casey N, Ta', 'Cong, Liu', 'Cynthia, Sung', 'Alex M, Butler', 'Latoya A, Stewart', 'Lyudmila, Ena', 'James R, Rogers', 'Junghwan, Lee', 'Anna, Ostropolets', 'Patrick B, Ryan', 'Hao, Liu', 'Shing M, Lee', 'Mitchell S V, Elkind', 'Chunhua, Weng'], ['Jimmy, Phuong', 'Elizabeth, Zampino', 'Nicholas, Dobbins', 'Juan, Espinoza', 'Daniella, Meeker', 'Heidi, Spratt', 'Charisse, Madlock-Brown', 'Nicole G, Weiskopf', 'Adam, Wilcox'], ['Matthias, Hunger', 'Kristina, Bardenheuer', 'Alun, Passey', 'Rene, Schade', 'Ruchika, Sharma', 'Clare, Hague']","'Carlen Reyes', 'Andrea Pistillo', 'Sergio Fernandez-Bertolin', 'Martina Recalde', 'Elena Roel', 'Diana Puente', 'Anthony G Sena', 'Clair Blacketer', 'Lana Lai', 'Thamir M Alshammari', 'Waheed-Ui-Rahman Ahmed', 'Osaid Alser', 'Heba Alghoul', 'Carlos Areia', 'Dalia Dawoud', 'Albert Prats-Uribe', 'Neus Valveny', 'Gabriel de Maeztu', 'Luisa Sorli Redo', 'Jordi Martinez Roldan', 'Inmaculada Lopez Montesinos', 'Lisa M Schilling', 'Asieh Golozar', 'Christian Reich', 'Jose D Posada', 'Nigam Shah', 'Seng Chan You', 'Kristine E Lynch', 'Scott L DuVall', 'Michael E Matheny', 'Fredrik Nyberg', 'Anna Ostropolets', 'George Hripcsak', 'Peter R Rijnbeek', 'Marc A Suchard', 'Patrick Ryan', 'Kristin Kostka', 'Talita Duarte-Salles', 'Anastasiya Nestsiarovich', 'Jenna M Reps', 'Michael E Matheny', 'Scott L DuVall', 'Kristine E Lynch', 'Maura Beaton', 'Xinzhuo Jiang', 'Matthew Spotnitz', 'Stephen R Pfohl', 'Nigam H Shah', 'Carmen Olga Torre', 'Christian G Reich', 'Dong Yun Lee', 'Sang Joon Son', 'Seng Chan You', 'Rae Woong Park', 'Patrick B Ryan', 'Christophe G Lambert', 'Ross D Williams', 'Jenna M Reps', 'Peter R Rijnbeek', 'Patrick B Ryan', 'Daniel Prieto-Alhambra', 'Ines Reinecke', 'Michele Zoch', 'Markus Wilhelm', 'Martin Sedlmayr', 'Franziska Bathelt', 'Emanuele Girani', 'Matteo Gabetta', 'Anna Alloni', 'Morena Stuppia', 'Lucia Sacchi', 'Nicola Barbarini', 'Antoine Lamer', 'Osama Abou-Arab', 'Alexandre Bourgeois', 'Adrien Parrot', 'Benjamin Popoff', 'Jean-Baptiste Beuscart', 'Benoit Tavernier', 'Mouhamed Djahoum Moussa', 'Sara Khalid', 'Cynthia Yang', 'Clair Blacketer', 'Talita Duarte-Salles', 'Sergio Fernandez-Bertolin', 'Chungsoo Kim', 'Rae Woong Park', 'Jimyung Park', 'Martijn J Schuemie', 'Anthony G Sena', 'Marc A Suchard', 'Seng Chan You', 'Peter R Rijnbeek', 'Jenna M Reps', 'Ines Reinecke', 'Michele Zoch', 'Christian Reich', 'Martin Sedlmayr', 'Franziska Bathelt', 'Martina Recalde', 'Elena Roel', 'Andrea Pistillo', 'Anthony G Sena', 'Albert Prats-Uribe', 'Waheed-Ul-Rahman Ahmed', 'Heba Alghoul', 'Thamir M Alshammari', 'Osaid Alser', 'Carlos Areia', 'Edward Burn', 'Paula Casajust', 'Dalia Dawoud', 'Scott L DuVall', 'Thomas Falconer', 'Sergio Fernandez-Bertolin', 'Asieh Golozar', 'Mengchun Gong', 'Lana Yin Hui Lai', 'Jennifer C E Lane', 'Kristine E Lynch', 'Michael E Matheny', 'Paras P Mehta', 'Daniel R Morales', 'Karthik Natarjan', 'Fredrik Nyberg', 'Jose D Posada', 'Christian G Reich', 'Peter R Rijnbeek', 'Lisa M Schilling', 'Karishma Shah', 'Nigam H Shah', 'Vignesh Subbian', 'Lin Zhang', 'Hong Zhu', 'Patrick Ryan', 'Daniel Prieto-Alhambra', 'Kristin Kostka', 'Talita Duarte-Salles', 'Zhehuan Chen', 'Hao Liu', 'Alex Butler', 'Anna Ostropolets', 'Chunhua Weng', 'Vlasios K Dimitriadis', 'George I Gavriilidis', 'Pantelis Natsiavas', 'Albert Prats-Uribe', 'Anthony G Sena', 'Lana Yin Hui Lai', 'Waheed-Ul-Rahman Ahmed', 'Heba Alghoul', 'Osaid Alser', 'Thamir M Alshammari', 'Carlos Areia', 'William Carter', 'Paula Casajust', 'Dalia Dawoud', 'Asieh Golozar', 'Jitendra Jonnagaddala', 'Paras P Mehta', 'Mengchun Gong', 'Daniel R Morales', 'Fredrik Nyberg', 'Jose D Posada', 'Martina Recalde', 'Elena Roel', 'Karishma Shah', 'Nigam H Shah', 'Lisa M Schilling', 'Vignesh Subbian', 'David Vizcaya', 'Lin Zhang', 'Ying Zhang', 'Hong Zhu', 'Li Liu', 'Jaehyeong Cho', 'Kristine E Lynch', 'Michael E Matheny', 'Seng Chan You', 'Peter R Rijnbeek', 'George Hripcsak', 'Jennifer Ce Lane', 'Edward Burn', 'Christian Reich', 'Marc A Suchard', 'Talita Duarte-Salles', 'Kristin Kostka', 'Patrick B Ryan', 'Daniel Prieto-Alhambra', 'Justin T Reese', 'Ben Coleman', 'Lauren Chan', 'Hannah Blau', 'Tiffany J Callahan', 'Luca Cappelletti', 'Tommaso Fontana', 'Katie Rebecca Bradwell', 'Nomi L Harris', 'Elena Casiraghi', 'Giorgio Valentini', 'Guy Karlebach', 'Rachel Deer', 'Julie A McMurry', 'Melissa A Haendel', 'Christopher G Chute', 'Emily Pfaff', 'Richard Moffitt', 'Heidi Spratt', 'Jasvinder Singh', 'Christopher J Mungall', 'Andrew E Williams', 'Peter N Robinson', 'George Hripcsak', 'Martijn J Schuemie', 'David Madigan', 'Patrick B Ryan', 'Marc A Suchard', 'Eng Hooi Tan', 'Anthony G Sena', 'Albert Prats-Uribe', 'Seng Chan You', 'Waheed-Ul-Rahman Ahmed', 'Kristin Kostka', 'Christian Reich', 'Scott L Duvall', 'Kristine E Lynch', 'Michael E Matheny', 'Talita Duarte-Salles', 'Sergio Fernandez Bertolin', 'George Hripcsak', 'Karthik Natarajan', 'Thomas Falconer', 'Matthew Spotnitz', 'Anna Ostropolets', 'Clair Blacketer', 'Thamir M Alshammari', 'Heba Alghoul', 'Osaid Alser', 'Jennifer C E Lane', 'Dalia M Dawoud', 'Karishma Shah', 'Yue Yang', 'Lin Zhang', 'Carlos Areia', 'Asieh Golozar', 'Martina Recalde', 'Paula Casajust', 'Jitendra Jonnagaddala', 'Vignesh Subbian', 'David Vizcaya', 'Lana Y H Lai', 'Fredrik Nyberg', 'Daniel R Morales', 'Jose D Posada', 'Nigam H Shah', 'Mengchun Gong', 'Arani Vivekanantham', 'Aaron Abend', 'Evan P Minty', 'Marc Suchard', 'Peter Rijnbeek', 'Patrick B Ryan', 'Daniel Prieto-Alhambra', 'Daniel Prieto-Alhambra', 'Kristin Kostka', 'Talita Duarte-Salles', 'Albert Prats-Uribe', 'Anthony Sena', 'Andrea Pistillo', 'Sara Khalid', 'Lana Lai', 'Asieh Golozar', 'Thamir M Alshammari', 'Dalia Dawoud', 'Fredrik Nyberg', 'Adam Wilcox', 'Alan Andryc', 'Andrew Williams', 'Anna Ostropolets', 'Carlos Areia', 'Chi Young Jung', 'Christopher Harle', 'Christian Reich', 'Clair Blacketer', 'Daniel Morales', 'David A Dorr', 'Edward Burn', 'Elena Roel', 'Eng Hooi Tan', 'Evan Minty', 'Frank DeFalco', 'Gabriel de Maeztu', 'Gigi Lipori', 'Heba Alghoul', 'Hong Zhu', 'Jason Thomas', 'Jiang Bian', 'Jimyung Park', 'Jordi Martinez Roldan', 'Jose Posada', 'Juan M Banda', 'Juan P Horcajada', 'Julianna Kohler', 'Karishma Shah', 'Karthik Natarajan', 'Kristine Lynch', 'Li Liu', 'Lisa Schilling', 'Martina Recalde', 'Matthew Spotnitz', 'Mengchun Gong', 'Michael Matheny', 'Neus Valveny', 'Nicole Weiskopf', 'Nigam Shah', 'Osaid Alser', 'Paula Casajust', 'Rae Woong Park', 'Robert Schuff', 'Sarah Seager', 'Scott DuVall', 'Seng Chan You', 'Seokyoung Song', 'Sergio Fernandez-Bertolin', 'Stephen Fortin', 'Tanja Magoc', 'Thomas Falconer', 'Vignesh Subbian', 'Vojtech Huser', 'Waheed-Ul-Rahman Ahmed', 'William Carter', 'Yin Guan', 'Yankuic Galvan', 'Xing He', 'Peter Rijnbeek', 'George Hripcsak', 'Patrick Ryan', 'Marc Suchard', 'Jenna M Reps', 'Chungsoo Kim', 'Ross D Williams', 'Aniek F Markus', 'Cynthia Yang', 'Talita Duarte-Salles', 'Thomas Falconer', 'Jitendra Jonnagaddala', 'Andrew Williams', 'Sergio Fernandez-Bertolin', 'Scott L DuVall', 'Kristin Kostka', 'Gowtham Rao', 'Azza Shoaibi', 'Anna Ostropolets', 'Matthew E Spotnitz', 'Lin Zhang', 'Paula Casajust', 'Ewout W Steyerberg', 'Fredrik Nyberg', 'Benjamin Skov Kaas-Hansen', 'Young Hwa Choi', 'Daniel Morales', 'Siaw-Teng Liaw', 'Maria Tereza Fernandes Abrahao', 'Carlos Areia', 'Michael E Matheny', 'Kristine E Lynch', 'Maria Aragon', 'Rae Woong Park', 'George Hripcsak', 'Christian G Reich', 'Marc A Suchard', 'Seng Chan You', 'Patrick B Ryan', 'Daniel Prieto-Alhambra', 'Peter R Rijnbeek', 'Jennifer C E Lane', 'James Weaver', 'Kristin Kostka', 'Talita Duarte-Salles', 'Maria Tereza F Abrahao', 'Heba Alghoul', 'Osaid Alser', 'Thamir M Alshammari', 'Carlos Areia', 'Patricia Biedermann', 'Juan M Banda', 'Edward Burn', 'Paula Casajust', 'Kristina Fister', 'Jill Hardin', 'Laura Hester', 'George Hripcsak', 'Benjamin Skov Kaas-Hansen', 'Sajan Khosla', 'Spyros Kolovos', 'Kristine E Lynch', 'Rupa Makadia', 'Paras P Mehta', 'Daniel R Morales', 'Henry Morgan-Stewart', 'Mees Mosseveld', 'Danielle Newby', 'Fredrik Nyberg', 'Anna Ostropolets', 'Rae Woong Park', 'Albert Prats-Uribe', 'Gowtham A Rao', 'Christian Reich', 'Peter Rijnbeek', 'Anthony G Sena', 'Azza Shoaibi', 'Matthew Spotnitz', 'Vignesh Subbian', 'Marc A Suchard', 'David Vizcaya', 'Haini Wen', 'Marcel de Wilde', 'Junqing Xie', 'Seng Chan You', 'Lin Zhang', 'Simon Lovestone', 'Patrick Ryan', 'Daniel Prieto-Alhambra', 'Nicolas H Thurin', 'Regis Lassalle', 'Martijn Schuemie', 'Marine Penichon', 'Joshua J Gagne', 'Jeremy A Rassen', 'Jacques Benichou', 'Alain Weill', 'Patrick Blin', 'Nicholas Moore', 'Cecile Droz-Perroteau', 'Sooin Choi', 'Soo Jeong Choi', 'Jin Kuk Kim', 'Ki Chang Nam', 'Suehyun Lee', 'Ju Han Kim', 'You Kyoung Lee', 'Nicolas Paris', 'Antoine Lamer', 'Adrien Parrot', 'Miguel Pedrera', 'Noelia Garcia', 'Paula Rubio', 'Juan Luis Cruz', 'Jose Luis Bernal', 'Pablo Serrano', 'Matteo Gabetta', 'Anna Alloni', 'Francesca Polce', 'Giordano Lanzola', 'Enea Parimbelli', 'Nicola Barbarini', 'Yongseok Mun', 'Seng Chan You', 'Da Yun Lee', 'Seok Kim', 'Yoo-Ri Chung', 'Kihwang Lee', 'Ji Hun Song', 'Young Gun Park', 'Young Hoon Park', 'Young-Jung Roh', 'Se Joon Woo', 'Kyu Hyung Park', 'Rae Woong Park', 'Sooyoung Yoo', 'Dong-Jin Chang', 'Sang Jun Park', 'Patricia Biedermann', 'Rose Ong', 'Alexander Davydov', 'Alexandra Orlova', 'Philip Solovyev', 'Hong Sun', 'Graham Wetherill', 'Monika Brand', 'Eva-Maria Didden', 'William A Wood', 'Peter Marks', 'Robert M Plovnick', 'Kathleen Hewitt', 'Donna S Neuberg', 'Sam Walters', 'Brendan K Dolan', 'Emily A Tucker', 'Charles S Abrams', 'Alexis A Thompson', 'Kenneth C Anderson', 'Paul Kluetz', 'Ann Farrell', 'Donna Rivera', 'Matthew Gertzog', 'Gregory Pappas', 'Yuan Peng', 'Azadeh Nassirian', 'Najia Ahmadi', 'Martin Sedlmayr', 'Franziska Bathelt', 'Vaclav Papez', 'Maxim Moinat', 'Stefan Payralbe', 'Folkert W Asselbergs', 'R Thomas Lumbers', 'Harry Hemingway', 'Richard Dobson', 'Spiros Denaxas', 'Xinhang Li', 'Hao Liu', 'Fabricio Kury', 'Chi Yuan', 'Alex Butler', 'Yingcheng Sun', 'Anna Ostropolets', 'Hua Xu', 'Chunhua Weng', 'Selva Muthu Kumaran Sathappan', 'Young Seok Jeon', 'Trung Kien Dang', 'Su Chi Lim', 'Yi-Ming Shao', 'E Shyong Tai', 'Mengling Feng', 'Clair Blacketer', 'Frank J Defalco', 'Patrick B Ryan', 'Peter R Rijnbeek', 'Jin Ge', 'Mark J Pletcher', 'Jennifer C Lai', 'Joao Rafael Almeida', 'Joao Figueira Silva', 'Sergio Matos', 'Jose Luis Oliveira', 'Christophe Gaudet-Blavignac', 'Jean Louis Raisaro', 'Vasundra Toure', 'Sabine Osterle', 'Katrin Crameri', 'Christian Lovis', 'Ruth M Reeves', 'Lee Christensen', 'Jeremiah R Brown', 'Michael Conway', 'Maxwell Levis', 'Glenn T Gobbel', 'Rashmee U Shah', 'Christine Goodrich', 'Iben Ricket', 'Freneka Minter', 'Andrew Bohm', 'Bruce E Bray', 'Michael E Matheny', 'Wendy Chapman', 'Tarun Karthik Kumar Mamidi', 'Thi K Tran-Nguyen', 'Ryan L Melvin', 'Elizabeth A Worthey', 'Junghwan Lee', 'Cong Liu', 'Jae Hyun Kim', 'Alex Butler', 'Ning Shang', 'Chao Pang', 'Karthik Natarajan', 'Patrick Ryan', 'Casey Ta', 'Chunhua Weng', 'Gyu Lee Kim', 'Yu Hyeon Yi', 'Hye Rim Hwang', 'Jinmi Kim', 'Youngmin Park', 'Yun Jin Kim', 'Jeong Gyu Lee', 'Young Jin Tak', 'Seung Hun Lee', 'Sang Yeoup Lee', 'Youn Hye Cho', 'Eun Ju Park', 'Youngin Lee', 'SeHee Oh', 'MinDong Sung', 'Yumie Rhee', 'Namki Hong', 'Yu Rang Park', 'Raphael W Majeed', 'Patrick Fischer', 'Andreas Gunther', 'Raphael W Majeed', 'Mark R Stohr', 'Andreas Gunther', 'Eugenia Rinaldi', 'Sylvia Thun', 'Fabio Boudis', 'Guillaume Clement', 'Amelie Bruandet', 'Antoine Lamer', 'Michele Zoch', 'Christian Gierschner', 'Yuan Peng', 'Mirko Gruhl', 'Liz A Leutner', 'Martin Sedlmayr', 'Franziska Bathelt', 'Hyunah Shin', 'Suehyun Lee', 'Leslie A Lenert', 'Andrey V Ilatovskiy', 'James Agnew', 'Patricia Rudisill', 'Jeff Jacobs', 'Duncan Weatherston', 'Kenneth R Jr Deans', 'Byungkon Kang', 'Jisang Yoon', 'Ha Young Kim', 'Sung Jin Jo', 'Yourim Lee', 'Hye Jin Kam', 'Yingcheng Sun', 'Alex Butler', 'Latoya A Stewart', 'Hao Liu', 'Chi Yuan', 'Christopher T Southard', 'Jae Hyun Kim', 'Chunhua Weng', 'Hao Liu', 'Yuan Chi', 'Alex Butler', 'Yingcheng Sun', 'Chunhua Weng', 'Jimyung Park', 'Seng Chan You', 'Eugene Jeong', 'Chunhua Weng', 'Dongsu Park', 'Jin Roh', 'Dong Yun Lee', 'Jae Youn Cheong', 'Jin Wook Choi', 'Mira Kang', 'Rae Woong Park', 'Jeong-Whun Kim', 'Seok Kim', 'Borim Ryu', 'Wongeun Song', 'Ho-Young Lee', 'Sooyoung Yoo', 'Leslie A Lenert', 'Andrey V Ilatovskiy', 'James Agnew', 'Patricia Rudsill', 'Jeff Jacobs', 'Duncan Weatherston', 'Kenneth Deans', 'Hokyun Jeon', 'Seng Chan You', 'Seok Yun Kang', 'Seung In Seo', 'Jeremy L Warner', 'Rimma Belenkaya', 'Rae Woong Park', 'Jingqi Wang', 'Noor Abu-El-Rub', 'Josh Gray', 'Huy Anh Pham', 'Yujia Zhou', 'Frank J Manion', 'Mei Liu', 'Xing Song', 'Hua Xu', 'Masoud Rouhizadeh', 'Yaoyun Zhang', 'Yeonchan Seong', 'Seng Chan You', 'Anna Ostropolets', 'Yeunsook Rho', 'Jimyung Park', 'Jaehyeong Cho', 'Dmitry Dymshyts', 'Christian G Reich', 'Yunjung Heo', 'Rae Woong Park', 'Christian Maier', 'Lorenz A Kapsner', 'Sebastian Mate', 'Hans-Ulrich Prokosch', 'Stefan Kraus', 'Rimma Belenkaya', 'Michael J Gurley', 'Asieh Golozar', 'Dmitry Dymshyts', 'Robert T Miller', 'Andrew E Williams', 'Shilpa Ratwani', 'Anastasios Siapos', 'Vladislav Korsik', 'Jeremy Warner', 'W Scott Campbell', 'Donna Rivera', 'Tatiana Banokina', 'Elizaveta Modina', 'Shantha Bethusamy', 'Henry Morgan Stewart', 'Meera Patel', 'Ruijun Chen', 'Thomas Falconer', 'Rae Woong Park', 'Seng Chan You', 'Hokyun Jeon', 'Soe Jeong Shin', 'Christian Reich', 'Daniel R Morales', 'Mitchell M Conover', 'Seng Chan You', 'Nicole Pratt', 'Kristin Kostka', 'Talita Duarte-Salles', 'Sergio Fernandez-Bertolin', 'Maria Aragon', 'Scott L DuVall', 'Kristine Lynch', 'Thomas Falconer', 'Kees van Bochove', 'Cynthia Sung', 'Michael E Matheny', 'Christophe G Lambert', 'Fredrik Nyberg', 'Thamir M Alshammari', 'Andrew E Williams', 'Rae Woong Park', 'James Weaver', 'Anthony G Sena', 'Martijn J Schuemie', 'Peter R Rijnbeek', 'Ross D Williams', 'Jennifer C E Lane', 'Albert Prats-Uribe', 'Lin Zhang', 'Carlos Areia', 'Harlan M Krumholz', 'Daniel Prieto-Alhambra', 'Patrick B Ryan', 'George Hripcsak', 'Marc A Suchard', 'Seamus Kent', 'Edward Burn', 'Dalia Dawoud', 'Pall Jonsson', 'Jens Torup Ostby', 'Nigel Hughes', 'Peter Rijnbeek', 'Jacoline C Bouvy', 'Edward Burn', 'Anthony G Sena', 'Albert Prats-Uribe', 'Matthew Spotnitz', 'Scott DuVall', 'Kristine E Lynch', 'Michael E Matheny', 'Fredrik Nyberg', 'Waheed-Ul-Rahman Ahmed', 'Osaid Alser', 'Heba Alghoul', 'Thamir Alshammari', 'Lin Zhang', 'Paula Casajust', 'Carlos Areia', 'Karishma Shah', 'Christian Reich', 'Clair Blacketer', 'Alan Andryc', 'Stephen Fortin', 'Karthik Natarajan', 'Mengchun Gong', 'Asieh Golozar', 'Daniel Morales', 'Peter Rijnbeek', 'Vignesh Subbian', 'Elena Roel', 'Martina Recalde', 'Jennifer C E Lane', 'David Vizcaya', 'Jose D Posada', 'Nigam H Shah', 'Jitendra Jonnagaddala', 'Lana Yin Hui Lai', 'Francesc Xavier Aviles-Jurado', 'George Hripcsak', 'Marc A Suchard', 'Otavio T Ranzani', 'Patrick Ryan', 'Daniel Prieto-Alhambra', 'Kristin Kostka', 'Talita Duarte-Salles', 'Elizabeth T Jensen', 'Dana A Dabelea', 'Pradeep A Praveen', 'Anandakumar Amutha', 'Christine W Hockett', 'Scott P Isom', 'Toan C Ong', 'Viswanathan Mohan', ', Agostino Ralph Jr""', ', ', ', ', ', ', ', ', ', ', ', ', ', ', ', ', ', ', , 'Borim Ryu', 'Sooyoung Yoo', 'Seok Kim', 'Jinwook Choi', 'Seung-Hwa Lee', 'Kwang Jin Chun', 'Jungchan Park', 'Jinseob Kim', 'Ji Dong Sung', 'Rae Woong Park', 'Jinwook Choi', 'Kwangmo Yang', 'Kyung Ae Lee', 'Heung Yong Jin', 'Yu Ji Kim', 'Yong-Jin Im', 'Eun-Young Kim', 'Tae Sun Park', 'Yingcheng Sun', 'Alex Butler', 'Ibrahim Diallo', 'Jae Hyun Kim', 'Casey Ta', 'James R Rogers', 'Hao Liu', 'Chunhua Weng', 'Elena Roel', 'Andrea Pistillo', 'Martina Recalde', 'Anthony G Sena', 'Sergio Fernandez-Bertolin', 'Maria Aragon', 'Diana Puente', 'Waheed-Ul-Rahman Ahmed', 'Heba Alghoul', 'Osaid Alser', 'Thamir M Alshammari', 'Carlos Areia', 'Clair Blacketer', 'William Carter', 'Paula Casajust', 'Aedin C Culhane', 'Dalia Dawoud', 'Frank DeFalco', 'Scott L DuVall', 'Thomas Falconer', 'Asieh Golozar', 'Mengchun Gong', 'Laura Hester', 'George Hripcsak', 'Eng Hooi Tan', 'Hokyun Jeon', 'Jitendra Jonnagaddala', 'Lana Y H Lai', 'Kristine E Lynch', 'Michael E Matheny', 'Daniel R Morales', 'Karthik Natarajan', 'Fredrik Nyberg', 'Anna Ostropolets', 'Jose D Posada', 'Albert Prats-Uribe', 'Christian G Reich', 'Donna R Rivera', 'Lisa M Schilling', 'Isabelle Soerjomataram', 'Karishma Shah', 'Nigam H Shah', 'Yang Shen', 'Matthew Spotniz', 'Vignesh Subbian', 'Marc A Suchard', 'Annalisa Trama', 'Lin Zhang', 'Ying Zhang', 'Patrick B Ryan', 'Daniel Prieto-Alhambra', 'Kristin Kostka', 'Talita Duarte-Salles', 'Jin Young Yoon', 'Jae Myung Cha', 'Ha Il Kim', 'Min Seob Kwak', 'Alison Callahan', 'Vladimir Polony', 'Jose D Posada', 'Juan M Banda', 'Saurabh Gombar', 'Nigam H Shah', 'Ha Il Kim', 'Jin Young Yoon', 'Min Seob Kwak', 'Jae Myung Cha', 'Chungsoo Kim', 'Seng Chan You', 'Jenna M Reps', 'Jae Youn Cheong', 'Rae Woong Park', 'Ha Il Kim', 'Jin Young Yoon', 'Min Seob Kwak', 'Jae Myung Cha', 'Anandakumar Amutha', 'Pradeep A Praveen', 'Christine W Hockett', 'Toan C Ong', 'Elizabeth T Jensen', 'Scott P Isom', ', Agostino Ralph B Jr""', ', ', ', ', ', ', ', ', ', ', ', ', ', ', ', ', , 'Christine W Hockett', 'Pradeep A Praveen', 'Toan C Ong', 'Anandakumar Amutha', 'Scott P Isom', 'Elizabeth T Jensen', ', Agostino Ralph B Jr""', ', ', ', ', ', ', ', ', ', ', ', ', ', ', , 'Martijn J Schuemie', 'Patrick B Ryan', 'Nicole Pratt', 'RuiJun Chen', 'Seng Chan You', 'Harlan M Krumholz', 'David Madigan', 'George Hripcsak', 'Marc A Suchard', 'Jenna M Reps', 'Peter Rijnbeek', 'Alana Cuthbert', 'Patrick B Ryan', 'Nicole Pratt', 'Martijn Schuemie', 'Talita Duarte-Salles', 'David Vizcaya', 'Andrea Pistillo', 'Paula Casajust', 'Anthony G Sena', 'Lana Yin Hui Lai', 'Albert Prats-Uribe', 'Waheed-Ul-Rahman Ahmed', 'Thamir M Alshammari', 'Heba Alghoul', 'Osaid Alser', 'Edward Burn', 'Seng Chan You', 'Carlos Areia', 'Clair Blacketer', 'Scott DuVall', 'Thomas Falconer', 'Sergio Fernandez-Bertolin', 'Stephen Fortin', 'Asieh Golozar', 'Mengchun Gong', 'Eng Hooi Tan', 'Vojtech Huser', 'Pablo Iveli', 'Daniel R Morales', 'Fredrik Nyberg', 'Jose D Posada', 'Martina Recalde', 'Elena Roel', 'Lisa M Schilling', 'Nigam H Shah', 'Karishma Shah', 'Marc A Suchard', 'Lin Zhang', 'Ying Zhang', 'Andrew E Williams', 'Christian G Reich', 'George Hripcsak', 'Peter Rijnbeek', 'Patrick Ryan', 'Kristin Kostka', 'Daniel Prieto-Alhambra', 'Noha Sharafeldin', 'Benjamin Bates', 'Qianqian Song', 'Vithal Madhira', 'Yao Yan', 'Sharlene Dong', 'Eileen Lee', 'Nathaniel Kuhrt', 'Yu Raymond Shao', 'Feifan Liu', 'Timothy Bergquist', 'Justin Guinney', 'Jing Su', 'Umit Topaloglu', 'Tellen D Bennett', 'Richard A Moffitt', 'Janos G Hajagos', 'Benjamin Amor', 'Adit Anand', 'Mark M Bissell', 'Katie Rebecca Bradwell', 'Carolyn Bremer', 'James Brian Byrd', 'Alina Denham', 'Peter E DeWitt', 'Davera Gabriel', 'Brian T Garibaldi', 'Andrew T Girvin', 'Justin Guinney', 'Elaine L Hill', 'Stephanie S Hong', 'Hunter Jimenez', 'Ramakanth Kavuluru', 'Kristin Kostka', 'Harold P Lehmann', 'Eli Levitt', 'Sandeep K Mallipattu', 'Amin Manna', 'Julie A McMurry', 'Michele Morris', 'John Muschelli', 'Andrew J Neumann', 'Matvey B Palchuk', 'Emily R Pfaff', 'Zhenglong Qian', 'Nabeel Qureshi', 'Seth Russell', 'Heidi Spratt', 'Anita Walden', 'Andrew E Williams', 'Jacob T Wooldridge', 'Yun Jae Yoo', 'Xiaohan Tanner Zhang', 'Richard L Zhu', 'Christopher P Austin', 'Joel H Saltz', 'Ken R Gersing', 'Melissa A Haendel', 'Christopher G Chute', 'Nicholas P Giangreco', 'Nicholas P Tatonetti', 'RuiJun Chen', 'Marc A Suchard', 'Harlan M Krumholz', 'Martijn J Schuemie', 'Steven Shea', 'Jon Duke', 'Nicole Pratt', 'Christian G Reich', 'David Madigan', 'Seng Chan You', 'Patrick B Ryan', 'George Hripcsak', 'Jean-Francois Ethier', 'Francois Goyer', 'Paul Fabry', 'Adrien Barton', 'Robert M Cronin', 'Alese E Halvorson', 'Cassie Springer', 'Xiaoke Feng', 'Lina Sulieman', 'Roxana Loperena-Cortes', 'Kelsey Mayo', 'Robert J Carroll', 'Qingxia Chen', 'Brian K Ahmedani', 'Jason Karnes', 'Bruce Korf', ', Donnell Christopher J""', ', ', , 'Xiangmin Ji', 'Guimei Cui', 'Chengzhen Xu', 'Jie Hou', 'Yunfei Zhang', 'Yan Ren', 'Jenna M Reps', 'Patrick Ryan', 'P R Rijnbeek', 'Xintong Li', 'Lana Yh Lai', 'Anna Ostropolets', 'Faaizah Arshad', 'Eng Hooi Tan', 'Paula Casajust', 'Thamir M Alshammari', 'Talita Duarte-Salles', 'Evan P Minty', 'Carlos Areia', 'Nicole Pratt', 'Patrick B Ryan', 'George Hripcsak', 'Marc A Suchard', 'Martijn J Schuemie', 'Daniel Prieto-Alhambra', 'Ye Ye', 'Seemran Barapatre', 'Michael K Davis', 'Keith O Elliston', 'Christos Davatzikos', 'Andrey Fedorov', 'Jean-Christophe Fillion-Robin', 'Ian Foster', 'John R Gilbertson', 'Andras Lasso', 'James V Miller', 'Martin Morgan', 'Steve Pieper', 'Brigitte E Raumann', 'Brion D Sarachan', 'Guergana Savova', 'Jonathan C Silverstein', 'Donald P Taylor', 'Joyce B Zelnis', 'Guo-Qiang Zhang', 'Jamie Cuticchia', 'Michael J Becich', 'Joon-Hyop Lee', 'Suhyun Kim', 'Kwangsoo Kim', 'Young Jun Chai', 'Hyeong Won Yu', 'Su-Jin Kim', 'June Young Choi', 'Yoo Seung Chung', 'Kyu Eun Lee', 'Ka Hee Yi', 'Jill Hardin', 'Jenna M Reps', 'Chi Yuan', 'Patrick B Ryan', 'Casey N Ta', 'Jae Hyun Kim', 'Ziran Li', 'Chunhua Weng', 'Christina Schuttler', 'Hans-Ulrich Prokosch', 'Martin Sedlmayr', 'Brita Sedlmayr', 'Jae Hyun Kim', 'Casey N Ta', 'Cong Liu', 'Cynthia Sung', 'Alex M Butler', 'Latoya A Stewart', 'Lyudmila Ena', 'James R Rogers', 'Junghwan Lee', 'Anna Ostropolets', 'Patrick B Ryan', 'Hao Liu', 'Shing M Lee', 'Mitchell S V Elkind', 'Chunhua Weng', 'Jimmy Phuong', 'Elizabeth Zampino', 'Nicholas Dobbins', 'Juan Espinoza', 'Daniella Meeker', 'Heidi Spratt', 'Charisse Madlock-Brown', 'Nicole G Weiskopf', 'Adam Wilcox', 'Matthias Hunger', 'Kristina Bardenheuer', 'Alun Passey', 'Rene Schade', 'Ruchika Sharma', 'Clare Hague'","['A Anil Sinaci', 'A Bauer-Mehren', 'Aakriti Gupta', 'Aaron Abend', 'Aaron Mansfield', 'Abraham G Hartzema', 'Achim Michel-Backofen', 'Adam B Wilcox', 'Adel A Alrwisan', 'Adit Anand', 'Adler Perotte', 'Adrien Barton', 'Adrien Parrot', 'Aedin C Culhane', 'Agma J M Traina', 'Agostino Ralph B J', 'Agostino Ralph J', 'Ahmad Baghal', 'Aize Cao', 'Ajit Londhe', 'Alain Weill', 'Alan Andryc', 'Alan E Bauck', 'Alana Cuthbert', 'Albert Prats-Uribe', 'Alberto Malovini', 'Alein T Chun', 'Alejandro Schuler', 'Alese E Halvorson', 'Alessandro Pasqua', 'Alex Butler', 'Alex Eavis', 'Alex J Elliot', 'Alexander Davydov', 'Alexander M Walker', 'Alexander Rusanov', 'Alexander Schoberl', 'Alexandra Jacunski', 'Alexandra Orlova', 'Alexandre Bourgeois', 'Alexandre Yahi', 'Alexis A Thompson', 'Alina Denham', 'Alison Callahan', 'Alison Cave', 'Aliya Gifford', 'Aloka Chakravarty', 'Alun Passey', 'Amanda Alberga', 'Amelia Henderson', 'Amelia J Averitt', 'Amelie Bruandet', 'Amin Manna', 'Amy Freedman', 'Amy Matcho', 'Ana Szarfman', 'Anandakumar Amutha', 'Anando Sen', 'Anastasios Siapos', 'Anastasiya Nestsiarovich', 'Andras Lasso', 'Andrea Batch', 'Andrea Donatini', 'Andrea Haberson', 'Andrea Pistillo', 'Andrea V Margulis', 'Andreas Gunther', 'Andrew Bate', 'Andrew Bohm', 'Andrew E Williams', 'Andrew Goldstein', 'Andrew J Neumann', 'Andrew T Girvin', 'Andrew Wen', 'Andrey Fedorov', 'Andrey V Ilatovskiy', 'Aniek F Markus', 'Anil Pacaci', 'Anita Walden', 'Ann Farrell', 'Anna Alloni', 'Anna Ostropolets', 'Annalisa Trama', 'Anthony G Sena', 'Anthony Molinaro', 'Anthony Reckard', 'Antoine Lamer', 'Anusha Bompelli', 'Arani Vivekanantham', 'Asieh Golozar', 'Atul J Butte', 'Aviram Weiss', 'Azadeh Nassirian', 'Aziz Boxwala', 'Azza Shoaibi', 'B Mosseveld', 'Barbara Benoit', 'Bas de Veer', 'Behnood Bikdeli', 'Belay B Yimer', 'Ben Coleman', 'Benjamin Amor', 'Benjamin Bates', 'Benjamin Popoff', 'Benjamin S Glicksberg', 'Benjamin Skov Kaas-Hansen', 'Benjamin Teeter', 'Benjamin Viernes', 'Benoit Tavernier', 'Berit Kerner', 'Bethany M Kwan', 'Bethany Percha', 'Bethene D Britt', 'Bing Cai', 'Bo Zhao', 'Borim Ry', 'Borim Ryu', 'Boris De Vloed', 'Boris Oskotsky', 'Brandon T Suehs', 'Brendan K Dolan', 'Brett K Beaulieu-Jones', 'Brett South', 'Brian C Sauer', 'Brian E Dixon', 'Brian K Ahmedani', 'Brian Nicholson', 'Brian T Garibaldi', 'Brigitte E Raumann', 'Brion D Sarachan', 'Brita Sedlmayr', 'Bruce E Bray', 'Bruce Korf', 'Bruce M Psaty', 'Bruce N Davidson', 'Bumhee Park', 'Byungkon Kang', 'C Friedman', 'C Haverkamp', 'C Jason Liang', 'C Maier', 'Carlen Reyes', 'Carlos Areia', 'Carmelo Montalbano', 'Carmen O Torre', 'Carmen Olga Torre', 'Carmen Schade-Brittinger', 'Carol Friedman', 'Carolyn Bremer', 'Carolyn D Britten', 'Carolyn L Westhoff', 'Casey N Ta', 'Cassie Springer', 'Cecile Droz-Perroteau', 'Cecilia Okusi', 'Chan Hyuk Park', 'Chantelle Hardy', 'Chao Pang', 'Charisse Madlock-Brown', 'Charles Bailey', 'Charles F 3rd Reynolds', 'Charles S Abrams', 'Chelsea L Michael', 'Chen Wen', 'Chengsheng Mao', 'Chengzhen Xu', 'Chi Young Jung', 'Chi Yuan', 'Chien-Chou Su', 'Chongliang Luo', 'Chris Bates', 'Chris Knoll', 'Chris Uhrich', 'Christel Daniel', 'Christian Gierschner', 'Christian Gulden', 'Christian Lovis', 'Christian Maier', 'Christian Reich', 'Christina Schuttler', 'Christine Goodrich', 'Christine W Hockett', 'Christoph Rinner', 'Christophe G Lambert', 'Christophe Gaudet-Blavignac', 'Christopher B Forrest', 'Christopher G Chute', 'Christopher Harle', 'Christopher Herrick', 'Christopher J Mungall', 'Christopher P Austin', 'Christopher T Southard', 'Christopher Wendl', 'Christos Davatzikos', 'Chuck Wentworth', 'Chungsoo Kim', 'Chunhua Weng', 'Clair Blacketer', 'Claudio Cricelli', 'Clifford H Spital', 'Cong Liu', 'Cynthia Sung', 'Cynthia Yang', 'D Madigan', 'D Meeker', 'D Weibel', 'Da Yun Lee', 'Dae-Soon Son', 'Dahye Shin', 'Dalia Dawoud', 'Dana A Dabelea', 'Daniel B Aruch', 'Daniel C Malone', 'Daniel Fife', 'Daniel M Lima', 'Daniel Park', 'Daniel Prieto-Alhambra', 'Daniel R Morales', 'Daniella Meeker', 'Danielle Newby', 'Davera Gabriel', 'David A Dorr', 'David Bertoch', 'David Goldstein', 'David Gotz', 'David J Albers', 'David K Vawdrey', 'David Madigan', 'David Martin', 'David Page', 'David S Carrell', 'David Sontag', 'David Verloop', 'David Vizcaya', 'Debajyoti Datta', 'Debashis Ghosh', 'Deepak K Sharma', 'Demetra Tsapepas', 'Deniz Gezgin', 'Dennis Toddenroth', 'Denys Kaduk', 'Derek E Smith', 'Devika Subramanian', 'Diana Puente', 'Dipak Kalra', 'Dirk Colaert', 'Divneet Mandair', 'Dmitry Dymshyts', 'Don Sun', 'Donahue Smith', 'Donald P Taylor', 'Dong Ki Kim', 'Dong Kyun Park', 'Dong Yun Lee', 'Dong-Jin Chang', 'DongSu Park', 'Donna Rivera', 'Donna S Neuberg', 'Donnell Christopher ', 'Douglas J Perkins', 'Dukyong Yoon', 'Duncan Weatherston', 'E A Vos', 'E Horvitz', 'E Shyong Tai', 'Edeltraut Garbe', 'Edoardo Vacchi', 'Edward Burn', 'Edward Chia-Cheng Lai', 'Eileen Lee', 'Eimear E Kenny', 'Elaine L Hill', 'Elena Casiraghi', 'Elena Roel', 'Eli Levitt', 'Elias Brandt', 'Elisa Bianchini', 'Elizabeth A Worthey', 'Elizabeth Hanchrow', 'Elizabeth T Jensen', 'Elizabeth Zampino', 'Elizaveta Modina', 'Else Krajenbrink', 'Emanuele Carlini', 'Emanuele Girani', 'Emily A Tucker', 'Emily Pfaff', 'Emily Welebob', 'Emmanuel Chazard', 'Enea Parimbelli', 'Eng Hooi Tan', 'Eric Tchetgen Tchetgen', 'Erica A Voss', 'Eugene Jeong', 'Eugenia Rinaldi', 'Eugenia Rutenberg', 'Eun Ju Park', 'Eun Kyoung Ahn', 'Eun-Young Jung', 'Eun-Young Kim', 'Eunsil Yoon', 'Eva-Maria Didden', 'Evan Minty', 'Evan T Sholle', 'Evropi Theodoratou', 'Ewout W Steyerberg', 'F Berger', 'F FitzHenry', 'F S Resnic', 'Faaizah Arshad', 'Fabio A Pires', 'Fabio Boudis', 'Fabricio Kury', 'Faraz S Ahmad', 'Fatemah A Alnofal', 'Fei Wang', 'Feichen Shen', 'Feifan Liu', 'Feng Cheng', 'Fernanda Polubriaginof', 'Filipa Ferreira', 'Folkert W Asselbergs', 'Francesc Xavier Aviles-Jurado', 'Francesca Polce', 'Francesco Innocenti', 'Francesco Lapi', 'Francesco Profili', 'Francois Goyer', 'Frank D Mentch', 'Frank J Defalco', 'Frank Manion', 'Franziska Bathelt', 'Fred Prior', 'Fredrik Nyberg', 'Freneka Minter', 'Fuyong Xing', 'G Honing', 'G Hripcsak', 'G Niklas Noren', 'G Trifiro', 'Gabriel A Brat', 'Gabriel de Maeztu', 'Gail J Roboz', 'Gary Howsam', 'Gary Meininger', 'Gavin Dabrera', 'Gayatri Amirthalingam', 'Gayo Diallo', 'George Argyriou', 'George Hripcsak', 'George I Gavriilidis', 'Giampiero Mazzaglia', 'Gianluca Trifiro', 'Gianmario Candore', 'Gigi Lipori', 'Gilbert S Omenn', 'Gillian M Belbin', 'Gillian Smith', 'Gino Picelli', 'Giordano Lanzola', 'Giorgio Valentini', 'Giovanni Mels', 'Giulia Dal Co', 'Giuseppe Roberto', 'Glenn T Gobbel', 'Gokce B Laleci Erturkmen', 'Gowtham A Rao', 'Graham Wetherill', 'Gregoire Ficheur', 'Gregorio Coronado', 'Gregory Pappas', 'Gregory W Hruby', 'Griffin M Weber', 'Guan N Guo', 'Guergana Savova', 'Guilherme Del Fiol', 'Guillaume Clement', 'Guimei Cui', 'Gunther Honing', 'Guo-Qiang Zhang', 'Guoqian Jiang', 'Gurvaneet Randhawa', 'Guy Karlebach', 'Gyu Lee Kim', 'H Storf', 'H U Prokosch', 'H W Fritsch', 'Ha Il Kim', 'Ha Young Kim', 'Hadi Kharrazi', 'Hafsa Bareen Syeda', 'Haini Wen', 'Hakki Kim', 'Hakon Hakonarson', 'Haleh Vatani', 'Hamed Abedtash', 'Hanlon Shau', 'Hannah Blau', 'Hans-Ulrich Prokosch', 'Hao Liu', 'Harald Binder', 'Harald Renz', 'Harlan M Krumholz', 'Harold P Lehmann', 'Harry Campbell', 'Harry Hemingway', 'Harry Hochheiser', 'Harshana Liyanage', 'Harshvinder Bhullar', 'Heather L Gardner', 'Heba Alghoul', 'Hee Hwang', 'Hee Young Na', 'Heidi Spratt', 'Henning Gall', 'Henry Morgan-Stewart', 'Hermann-Josef Rothkotter', 'Heung Yong Jin', 'Himanshu Sharma', 'Ho-Young Lee', 'Hojjat Salmasian', 'Hojun Park', 'Hokyun Jeon', 'Holger Storf', 'Hong Sun', 'Hong Xu', 'Hong Zhu', 'Hong-Seok Lim', 'Hongbo Lin', 'Hongfang Liu', 'Howard H Chang', 'Hua Xu', 'Huawei Wu', 'Hubert Serve', 'Hunmin Kim', 'Hunter Jimenez', 'Huub Straatman', 'Huy Anh', 'Hye Jin Kam', 'Hye Rim Hwang', 'Hyejin Lee', 'Hyeon-Eui Kim', 'Hyeong Won Yu', 'Hyerim Ji', 'Hyunah Shin', 'Hyung Joon Joo', 'Hyunyoung Baek', 'Iacopo Cricelli', 'Ian C K Wong', 'Ian Chi Kei Wong', 'Ian Foster', 'Ian Wood', 'Iben Ricket', 'Ibrahim Diallo', 'Iftikhar J Kullo', 'Imho Jang', 'Ines Reinecke', 'Inmaculada Lopez Montesinos', 'Iris Pigeot', 'Isabelle Soerjomataram', 'Iuliana Ionita-Laza', 'J Bernarding', 'J Bonhoeffer', 'J C Denny', 'J Denton', 'J L Warner', 'J Laufer', 'J Marc Overhage', 'J Schuttler', 'J van der Lei', 'Jacob T Wooldridge', 'Jacoline C Bouvy', 'Jacqueline Yee', 'Jacques Benichou', 'Jae Hyun Kim', 'Jae Myung Cha', 'Jae Youn Cheong', 'Jaehyeong Cho', 'Jakob Zierk', 'James Agnew', 'James Brian Byrd', 'James D Brooks', 'James J Cimino', 'James R Rogers', 'James V Miller', 'James Weaver', 'Jamie Cuticchia', 'Jamie Lopez Bernal', 'Jan Christoph', 'Jang Wook Sohn', 'Jang-Hee Kim', 'Janos G Hajagos', 'Jason H Moore', 'Jason Karnes', 'Jason M Morrison', 'Jason Thomas', 'Jasvinder Singh', 'Jean Louis Raisaro', 'Jean-Baptiste Beuscart', 'Jean-Christophe Fillion-Robin', 'Jean-Francois Ethier', 'Jeeyae Choi', 'Jeff Brown', 'Jeff Jacobs', 'Jeffrey G Klann', 'Jeffrey K Aronson', 'Jeffrey S Brown', 'Jenna M Reps', 'Jennifer A Pacheco', 'Jennifer C E Lane', 'Jennifer C Lai', 'Jennifer C Nelson', 'Jennifer L Williams', 'Jenny Staab', 'Jens Torup Ostby', 'Jeong Gyu Lee', 'Jeong-Whun Kim', 'Jeongeun Seo', 'Jeongmoon Lee', 'Jeremiah R Brown', 'Jeremy A Rassen', 'Jeremy L Warner', 'Jesse A Berlin', 'Jessica S Ancker', 'Jessica Tenenbaum', 'Ji Dong Sung', 'Ji Hun Song', 'Ji-Won Kim', 'Jian Wang', 'Jianfu Li', 'Jiang Bian', 'Jianjun Guo', 'Jianxiao Yang', 'Jiayi Tong', 'Jie Hou', 'Jie Xu', 'Jienchi Dorward', 'Jill Hardin', 'Jim Slattery', 'Jimeng Sun', 'Jimmy Phuong', 'Jimmy Quach', 'Jimyung Park', 'Jin Ge', 'Jin Kuk Kim', 'Jin Roh', 'Jin Wook Choi', 'Jin Young Yoon', 'Jing Su', 'Jingqi Wang', 'Jingsong Li', 'Jinmi Kim', 'Jinseob Kim', 'Jisang Yoon', 'Jitendra Jonnagaddala', 'Jiwoo Kim', 'Joan Lind', 'Joao Figueira Silva', 'Joao Rafael Almeida', 'Joel H Saltz', 'Joel N Swerdel', 'Joel T Dudley', 'Johan van der Lei', 'Johannes Bernarding', 'John Briggs', 'John H Holmes', 'John Muschelli', 'John Parry', 'John R Gilbertson', 'John Weeks', 'John Williams', 'Jon Duke', 'Jonathan Blaisure', 'Jonathan C Silverstein', 'Jonathan H Chen', 'Jonathan Leach', 'Jong Jin Yoo', 'Jong-Ho Kim', 'Jongsub Moon', 'Joon-Hyop Lee', 'Jordan F Karp', 'Jordi Martinez Roldan', 'Jos De Roo', 'Jose F Rodrigues-Jr', 'Jose Luis Bernal', 'Jose Luis Oliveira', 'Jose Posada', 'Joseph D Romano', 'Joseph S Ross', 'Josh Denny', 'Josh Gray', 'Joshua C Denny', 'Joshua J Gagne', 'Joyce B Zelnis', 'Ju Han Kim', 'Juan Espinoza', 'Juan Gao', 'Juan Luis Cruz', 'Juan M Banda', 'Juan P Horcajada', 'Juan Zhao', 'Judith A Racoosin', 'Julian Gruendner', 'Julian Sherlock', 'Julianna Kohler', 'Julie A McMurry', 'Jun Chen', 'Jun Li', 'Jun-Won Chung', 'June Young Choi', 'Jungchan Park', 'Junghwan Lee', 'Junqing Xie', 'Jurgen Hesser', 'Jurgen Schuttler', 'Justin Guinney', 'Justin Mower', 'Justin T Reese', 'Jyotishman Pathak', 'Ka Hee Yi', 'Kalyani Sonawane', 'Kandethody Ramachandran', 'Kari A Stephens', 'Karin Hedenmalm', 'Karishma Shah', 'Karthik Natarjan', 'Karthik Natrajan', 'Katherine D Crew', 'Kathleen Hewitt', 'Kathrin Blagec', 'Kathryn J Ruddy', 'Kathryn L Colborn', 'Katie Rebecca Bradwell', 'Katrin Crameri', 'Kavishwar B Wagholikar', 'Kayla Marie Howell', 'Kayla Quinnies', 'Kees van Bochove', 'Kefeng Ding', 'Keith O Elliston', 'Kelsey Mayo', 'Ken R Gersing', 'Ken Wiley', 'Kenneth C Anderson', 'Kenneth Jung', 'Kenneth K C Man', 'Kenneth R Jr Deans', 'Keran Moll', 'Kevin B Mahoney', 'Kevin Embree', 'Kevin G Moores', 'Kevin W Sexton', 'Keywan Sohrabi', 'Ki Chang Nam', 'Ki Joong Kim', 'Kihwang Lee', 'Kim Gates', 'Kimberly Westrich', 'Kipp W Johnson', 'Kiyoshi Kubota', 'Konrad J Karczewski', 'Kristin Kostka', 'Kristina Bardenheuer', 'Kristina Fister', 'Kristine E Lynch', 'Kristof Depraetere', 'Krzysztof Kiryluk', 'Kui Huang', 'Kurt Marquardt', 'Kushan Hewa', 'Kwang Jin Chun', 'Kwangmo Yang', 'Kwangsoo Kim', 'Kyoung Oh Kim', 'Kyu Eun Lee', 'Kyu Hyung Park', 'Kyung Ae Lee', 'L Lang', 'L Nookala', 'L Ohno-Machado', 'Lana Lai', 'Lana Y H Lai', 'Lana Yin Hui Lai', 'Lars Pedersen', 'Latoya A Stewart', 'Laura Hester', 'Lauren Chan', 'Lee Christensen', 'Leigh-Anne Dale', 'Lemuel R Waitman', 'Lena Davidson', 'Leslie A Lenert', 'Levon Utidjian', 'Li Hou', 'Li Liu', 'Li Wang', 'Lian Lian Duan', 'Liang Yao', 'Lin Zhang', 'Lina Sulieman', 'Lisa Bastarache', 'Lisa M Schilling', 'Liwei Wang', 'Liz A Leutner', 'Lorenz A Kapsner', 'Lori C Phillips', 'Lu Wang', 'Luca Cappelletti', 'Luca Chiovato', 'Lucia Sacchi', 'Lucila Ohno-Machado', 'Luisa Sorli Redo', 'Luke V Rasmussen', 'Lyudmila Ena', 'M E Matheny', 'M J Schuemie', 'M Sedlmayr', 'M Soledad Cepeda', 'Mahanazuddin Syed', 'Man Young Park', 'Manasa Tripathy', 'Manfred Hauben', 'Manlik Kwong', 'Marc A Suchard', 'Marc Rosenman', 'Marc Twagirumukiza', 'Marcel Erpenbeck', 'Marcel de Wilde', 'Marco A Gutierrez', 'Marcus A Badgeley', 'Margaret K Pasquale', 'Margaret Sin', 'Margarita Fernandez-Chas', 'Marguerite-Marie Defebvre', 'Maria Alba', 'Maria Aragon', 'Maria Tereza F Abrahao', 'Maria Zambon', 'Mariadonata Bellentani', 'Marie-Sophie Schwalm', 'Marine Penichon', 'Mark Braunstein', 'Mark J Pletcher', 'Mark Khayter', 'Mark Levenson', 'Mark M Bissell', 'Mark M Shervey', 'Mark R Stohr', 'Mark Thomas', 'Mark Velez', 'Markus Wilhelm', 'Martijn J Schuemie', 'Martin Boeker', 'Martin G Seneviratne', 'Martin Morgan', 'Martin Sedlmayr', 'Martina Recalde', 'Mary Regina Boland', 'Mary Simmerling', 'Maryam Garza', 'Masoud Rouhizadeh', 'Massimo Coppola', 'Matteo Gabetta', 'Matthew A H Joss', 'Matthew E Levine', 'Matthew E Spotnitz', 'Matthew Gertzog', 'Matthew Spotniz', 'Matthias Hunger', 'Matthias Samwald', 'Matthieu Doutreligne', 'Matvey B Palchuk', 'Maura Beaton', 'Maxim Moinat', 'Maxwell Levis', 'Meera Patel', 'Mees Mosseveld', 'Mehr Kashyap', 'Mei Liu', 'Melanie Boerries', 'Melissa A Haendel', 'Mengchun Gong', 'Mengling Feng', 'Meredith N Zozus', 'Meredith Nahm Zozus', 'Michael A Rosenberg', 'Michael Conway', 'Michael E Matheny', 'Michael Feher', 'Michael G Kahn', 'Michael Gurley', 'Michael J Becich', 'Michael K Davis', 'Michael Neumaier', 'Michael Sturzl', 'Michel Dumontier', 'Michele Kummel', 'Michele Morris', 'Michele Zoch', 'Miguel Pedrera', 'Min Seob Kwak', 'MinDong Sung', 'Ming Huang', 'Minh Pham', 'Mira Kang', 'Miriam C J M Sturkenboom', 'Mirko Gruhl', 'Mitchell M Conover', 'Mitchell S V Elkind', 'Mitra Rocca', 'Modesta Visca', 'Mohammad Khoshneshin', 'Mohammed Khalilia', 'Monika Brand', 'Morena Stuppia', 'Mouhamed Djahoum Moussa', 'Mui Van Zandt', 'Mustafa Yuksel', 'Myung Choi', 'N H Shah', 'N P Tatonetti', 'Na Hong', 'Nabeel Qureshi', 'Nadav Rappoport', 'Najia Ahmadi', 'Namki Hong', 'Nan Wang', 'Nancy Roderer', 'Nansu Zong', 'Nathan P Palmer', 'Nathaniel Kuhrt', 'Natnicha Vanitchanant', 'Naveen Ashish', 'Neil Dieterle', 'Nelson Lee', 'Neus Valveny', 'Nicholas Giangreco', 'Nicholas J Dobbins', 'Nicholas Jones', 'Nicholas Moore', 'Nicholas P Tatonetti', 'Nicholas Thomas', 'Nicola Barbarini', 'Nicolas Depas', 'Nicolas H Thurin', 'Nicolas Paris', 'Nicolas Wolf', 'Nicole G Weiskopf', 'Nicole Pratt', 'Niek Klazinga', 'Nigam H Shah', 'Nigel Hughes', 'Niklas Elmqvist', 'Nilay D Shah', 'Nils Gehlenborg', 'Ning Shang', 'Ning Zhang', 'Nir Nissim', 'Noelia Garcia', 'Noemie Elhadad', 'Noha Sharafeldin', 'Nomi L Harris', 'Noor Abu-El-Rub', 'Norman Rosenthal', 'Oleg Zhuk', 'Oluwafunmi Akinyemi', 'Omolola I Ogunyemi', 'Osaid Alser', 'Osama Abou-Arab', 'Otavio T Ranzani', 'Ozan Dikilitas', 'P E Stang', 'P Horki', 'P LePendu', 'P M Coloma', 'P R Rijnbeek', 'P Ryan', 'P Vormstein', 'Pablo Iveli', 'Pablo Serrano', 'Pall Jonsson', 'Pantelis Natsiavas', 'Paolo Francesconi', 'Paras Mehta', 'Pascal S Brandt', 'Patricia Biedermann', 'Patricia Glowe', 'Patricia Rudisill', 'Patrick B Ryan', 'Patrick Blin', 'Patrick Fischer', 'Patrick Hosokawa', 'Patrick Wu', 'Patrizio Dazzi', 'Paul Avillach', 'Paul E Stang', 'Paul Fabry', 'Paul Kluetz', 'Paul M Heider', 'Paul R Kingsbury', 'Paul Schmucker', 'Paula Casajust', 'Paula Rubio', 'Peggy Peissig', 'Peng Jin', 'Peng Zeng', 'Peter Arlett', 'Peter C Yang', 'Peter E DeWitt', 'Peter Greaves', 'Peter L Elkin', 'Peter Marks', 'Peter N Robinson', 'Peter R Rijnbeek', 'Peter Tarczy-Hornoch', 'Philip E Empey', 'Philip Nieri', 'Philip Solovyev', 'Philipp Daumke', 'Philipp Unberath', 'Phillip Sippl', 'Phung-Anh Alex Nguyen', 'Phyllis M Thangaraj', 'Pierre Gentine', 'Pradeep A Praveen', 'Pradipta Parhi', 'Prakash Adekkanattu', 'Praveen Kumar', 'Preciosa M Coloma', 'Premanand Tiwari', 'Qianli Ma', 'Qianqian Song', 'Qing Jiang', 'Qing Liu', 'Qingxia Chen', 'Qiong Wang', 'R Bieber', 'R D Boyce', 'R Harpaz', 'R J Carroll', 'R Thomas Lumbers', 'R W White', 'Rachel B Weinstein', 'Rachel Byford', 'Rachel Deer', 'Rae Woong Park', 'Rajesh Ranganath', 'Ramakanth Kavuluru', 'Rami Vanguri', 'Ramkiran Gouripeddi', 'Raphael W Majeed', 'Rashmee U Shah', 'Rave Harpaz', 'Rebecca E Chandler', 'Regina T Wulff', 'Regis Lassalle', 'Remi Frazier', 'Rene Schade', 'Riccardo Miotto', 'Richard A Hansen', 'Richard D Boyce', 'Richard Dobson', 'Richard Kiefer', 'Richard L Zhu', 'Richard Maclin', 'Richard Moffitt', 'Rick Larsen', 'Rimma Belenkaya', 'Rishi Saripalle', 'Ritu Khare', 'Robert A Black', 'Robert Carroll', 'Robert D Harrington', 'Robert J Caroll', 'Robert M Cronin', 'Robert M Plovnick', 'Robert McClure', 'Robert Miller', 'Robert Moskovitch', 'Robert Schuff', 'Robert W Dubois', 'Roberto Berni', 'Robin E Ferner', 'Rohit Vashisht', 'Roland Croner', 'Romina Blasini', 'Ron M C Herings', 'Rong-Min Baek', 'Rosa Gini', 'Rose Ong', 'Rose Qiu', 'Ross D Williams', 'Roxana Loperena-Cortes', 'Roy Pardee', 'Ruchika Sharma', 'Rui Duan', 'Rui Zhang', 'RuiJun Chen', 'Ruowang Li', 'Rupa Makadia', 'Ruth Brauer', 'Ruth Reeves', 'Ryan L Melvin', 'Ryan M Carnahan', 'S L Robbins', 'S Romio', 'S T Rosenbloom', 'S Vilar', 'S Y Zhan', 'Sabine Osterle', 'Sajan Khosla', 'Sally C Morton', 'Salma Begum', 'Salvatore Volpe', 'Sam Walters', 'Sandeep K Mallipattu', 'Sang Joon Son', 'Sang Jun Park', 'Sang Yeoup Lee', 'Sanghyung Jin', 'Sanjay Farshid', 'Sanket S Dhruva', 'Santiago Vilar', 'Sara Khalid', 'Sarah Mullin', 'Sarah Seager', 'Saurabh Gombar', 'Scott L DuVall', 'Scott P Isom', 'Se Joon Woo', 'SeHee Oh', 'Seamus Kent', 'Sean Mooney', 'Sebastian Hofer', 'Sebastian Mate', 'Seemran Barapatre', 'Seena Farzaneh', 'Seid Mussa Ahmed', 'Sejoon Lee', 'Selva Muthu Kumaran Sathappan', 'Seng Chan Yo', 'Sengwee Toh', 'Seo Jeong Shin', 'Seok Kim', 'Seok Yun Kang', 'Seokjin Haam', 'Seokyoung Song', 'Seongwon Lee', 'Sergio Fernandez-Bertolin', 'Sergio Matos', 'Seth Russell', 'Seung Hun Lee', 'Seung In Seo', 'Seung-Hwa Lee', 'Seungbin Oh', 'Seungho Jeon', 'Shanshan Lu', 'Shantha Bethusamy', 'Shaodian Zhang', 'Sharat Israni', 'Sharlene Dong', 'Shaun J Grannis', 'Shawn N Murphy', 'Shaymaa Al-Shukri', 'Shenqi Jing', 'Shilpa Ratwani', 'Shing M Lee', 'Shintaro Tsuji', 'Shinya Kimura', 'Shorabuddin Syed', 'Shreya Chakrabarti', 'Shuang Wang', 'Shuangqing Gao', 'Shumei Miao', 'Siaw-Teng Liaw', 'Sigfried Gold', 'Sijia Liu', 'Simon Lovestone', 'Simon de Lusignan', 'Simone Pinheiro', 'Siu Hui', 'Siyan Zhan', 'Sneha Iyengar', 'Soe Jeong Shin', 'Soko Setoguchi', 'Sonia Araujo', 'Soo Jeong Choi', 'Soo Yeon Cho', 'Sooin Choi', 'Sooyoung Yoo', 'Soyoung Yi', 'Spiros Denaxas', 'Spyros Kolovos', 'Stefan Kraus', 'Stefan Payralbe', 'Stephane M Meystre', 'Stephanie S Hong', 'Stephen A Deppen', 'Stephen Fortin', 'Stephen R Pfohl', 'Steve Pieper', 'Steven Bedrick', 'Steven M Handler', 'Steven Shea', 'Steven Simon', 'Stuart J Nelson', 'Su Chi Lim', 'Su-Jin Kim', 'Suat Gonul', 'Subashan Perera', 'Suehyun Lee', 'Suhyun Kim', 'Sukyoung Kim', 'Sumit Mohan', 'Sun Ah Choi', 'Sundaresan Murugesan', 'Sung Jin Jo', 'Sungha Park', 'Sungjae Jung', 'Suranga N Kasthurirathne', 'Susan Gruber', 'Susan R Heckbert', 'Suzanne Bakken', 'Syed A Husain', 'Sylvester Sakilay', 'Sylvia Cho', 'Sylvia Thun', 'T Ganslandt', 'T Herrmann', 'Tae Joon Kim', 'Tae Sun Park', 'Tal Lorberbaum', 'Talita Duarte-Salles', 'Tanja Magoc', 'Tao Shan', 'Tarun Karthik Kumar Mamidi', 'Tatiana Banokina', 'Tellen D Bennett', 'Terrence Adam', 'Thamir M Alshammari', 'Theodore C Goldstein', 'Theresa L Walunas', 'Thi K Tran-Nguyen', 'Thomas Falconer', 'Thomas Ganslandt', 'Thomas R Jr Campion', 'Thorsten Schwachhofer', 'Tian Kang', 'Tianshu Zhou', 'Tiffany J Callahan', 'Till Acker', 'Tim Varley', 'Timothy Bergquist', 'Timothy Miller', 'Tina M Hernandez-Boussard', 'Toan C Ong', 'Todd Lingren', 'Tommaso Fontana', 'Tony French', 'Traci Yamashita', 'Trevor Cohen', 'Trung Kien Dang', 'Umit Topaloglu', 'Usman Iqbal', 'Uy Hoang', 'Vaclav Papez', 'Valentina Barletta', 'Valentina Tibollo', 'Vasundra Toure', 'Victor Nwankwo', 'Victoria L Bartlett', 'Vignesh Subbian', 'Vinit P Nair', 'Virginia Rentko', 'Viswanathan Mohan', 'Vithal Madhira', 'Vitor Santos Costa', 'Vivek Rudrapatna', 'Vivian S Gainer', 'Vivienne Zhu', 'Vladimir Polony', 'Vladislav Korsik', 'Vlasios K Dimitriadis', 'Vojtech Huser', 'W DuMouchel', 'W Nick Street', 'W Scott Campbell', 'Waheed-Ui-Rahman Ahmed', 'Walter Cazzola', 'Walter Gall', 'Wei-Qi Wei', 'Weiguo Chen', 'Weihua Gao', 'Wendy Chapman', 'Werner Ceusters', 'William A Wood', 'William Carter', 'William DuMouchel', 'William Hersh', 'William Hinton', 'William Victor', 'Wongeun Song', 'Woon Geon Shin', 'Xavier Kurz', 'Xiangmin J', 'Xiangrui Meng', 'Xiao Dong', 'Xiaochun Li', 'Xiaofeng Zhou', 'Xiaohan Tanner Zhang', 'Xiaoke Feng', 'Xiaoliang Zhang', 'Xin Zhang', 'Xing He', 'Xing Song', 'Xinhang Li', 'Xintong Li', 'Xinzhuo Jiang', 'Xu Zuo', 'Xue Li', 'Y X Sun', 'Yan Ren', 'Yang Shen', 'Yankuic Galvan', 'Yanming Xie', 'Yanshan Wang', 'Yao Yan', 'Yaoyun Zhang', 'Ye Ye', 'Yea-Huei Kao Yang', 'Yeesuk Kim', 'Yeonchan Seong', 'Yeonsoo Hwang', 'Yerim Kim', 'Yeunsook Rho', 'Yi Zhou', 'Yi-Ming Shao', 'Yihua Xu', 'Yin Guan', 'Ying Li', 'Ying Wei', 'Ying Zhang', 'Yingcheng Sun', 'Yinghong Zhang', 'Yinying Lu', 'Yiqi Xu', 'Yixuan Guo', 'Yizhen Zhang', 'Yizhen Zhong', 'Yola Moride', 'Yong Chen', 'Yong-Jin Im', 'Yonghoon Jeon', 'Yonghua Jing', 'Yonghui Wu', 'Yongseok Mun', 'Yoni Halpern', 'Yoo Seung Chung', 'Yoo-Ri Chung', 'Yoon Jae Kim', 'You Kyoung Lee', 'You Sang Ko', 'Youlan Tang', 'Youn Hye Cho', 'Youn I Choi', 'Young Gun Park', 'Young Hoon Park', 'Young Hwa Choi', 'Young Jin Tak', 'Young Jun Chai', 'Young Seok Jeon', 'Young-Jung Roh', 'Youngin Lee', 'Youngjun Kim', 'Youngmin Park', 'Yourim Lee', 'Yu Hyeon Yi', 'Yu Ji Kim', 'Yu Rang Park', 'Yu Raymond Shao', 'Yu Tian', 'Yu Yang', 'Yu-Chuan Li', 'Yuan Luo', 'Yuan Peng', 'Yue Yang', 'Yue Yu', 'Yuechuchu Yin', 'Yueshi Zhu', 'Yuhui Zou', 'Yuji Feng', 'Yujia Zhou', 'Yukari Kamijima', 'Yumie Rhee', 'Yun Jae Yoo', 'Yun Jin Kim', 'Yun Liu', 'Yunfei Zhang', 'Yunjung Heo', 'Yuqi Si', 'Yuriy Khoma', 'Yuval Elovici', 'Yuval Shahar', 'Yuxi Tian', 'Z C Pei', 'Zach Shahn', 'Zachary H Moldwin', 'Zachary Shahn', 'Zhaobin Kuang', 'Zhe He', 'Zhehuan Chen', 'Zhenglong Qian', 'Zhenxing Xu', 'Zhong Yuan', 'Zhongmin Wang', 'Zhongqiu Huang', 'Ziran Li', 'Zuolei Dai', 'hommeaux Eri']",412,1319
10,2022,"Kangah Park, Yue Yu, Junqing Xie, Ines Reinecke, Hao Luo","['Carlen Reyes', 'Anastasiya Nestsiarovich', 'Ross D Williams', 'Ines Reinecke', 'Emanuele Girani', 'Antoine Lamer', 'Emily R Pfaff', 'Sara Khalid', 'Martina Recalde', 'Zhehuan Chen', 'Vlasios K Dimitriadis', 'Albert Prats-Uribe', 'Xu Zuo', 'Anna Ostropolets', 'Justin T Reese', 'George Hripcsak', 'Torunn Elise Sivesind', 'Eng Hooi Tan', 'Daniel Prieto-Alhambra', 'Jenna M Reps', 'Jennifer C E Lane', 'Martijn J Schuemie', 'Nicolas H Thurin', 'Pascal S Brandt', 'Jingqi Wang', 'Yu Tian', 'Yue Yu', 'Edward Burn', 'Fatemah A Alnofal', 'Rebecca E Chandler', 'Mehr Kashyap', 'Luke V Rasmussen', 'Youn I Choi', 'Brian E Dixon', 'Joel N Swerdel', 'Qiong Wang', 'Jiayi Tong', 'Victoria L Bartlett', 'Stephane M Meystre', 'Rimma Belenkaya', 'Guoqian Jiang', 'Daniel M Lima', 'Juan M Banda', 'Jeremy L Warner', 'James R Rogers', 'John Weeks', 'Martin G Seneviratne', 'Rohit Vashisht', 'Na Hong', 'Casey N Ta', 'Xin Zhang', 'Peter L Elkin', 'Matthew E Levine', 'Hans-Ulrich Prokosch', 'Fernanda C G Polubriaginof', 'C Maier', 'Seng Chan You', 'Rosa Gini', 'Vojtech Huser', 'Robert Moskovitch', 'Jon D Duke', 'E A Voss', 'Richard D Boyce', 'Anando Sen', 'Dukyong Yoon', 'Mary Regina Boland', 'Ying Li', 'Santiago Vilar', 'S Vilar', 'Sooin Choi', 'Nicolas Paris', 'Miguel Pedrera', 'Matteo Gabetta', 'Yongseok Mun', 'Patricia Biedermann', 'William A Wood', 'Yuan Peng', 'Vaclav Papez', 'Xinhang Li', 'Selva Muthu Kumaran Sathappan', 'Clair Blacketer', 'Jin Ge', 'Joao Rafael Almeida', 'Christophe Gaudet-Blavignac', 'Ruth M Reeves', 'Tarun Karthik Kumar Mamidi', 'Junghwan Lee', 'Gyu Lee Kim', 'SeHee Oh', 'Raphael W Majeed', 'Eugenia Rinaldi', 'Fabio Boudis', 'Michele Zoch', 'Hyunah Shin', 'Leslie A Lenert', 'Byungkon Kang', 'Anusha Bompelli', 'Yingcheng Sun', 'Hao Liu', 'Jimyung Park', 'Jeong-Whun Kim', 'Hokyun Jeon', 'Yeonchan Seong', 'Christian Maier', 'Daniel R Morales', 'Seamus Kent', 'Borim Ryu', 'Seungho Jeon', 'Jaehyeong Cho', 'Sylvia Cho', 'Gabriel A Brat', 'Christel Daniel', 'Shorabuddin Syed', 'Yeesuk Kim', 'Mirko Gruhl', 'Patrick Fischer', 'Philipp Unberath', 'Chelsea L Michael', 'Hunmin Kim', 'Hyerim Ji', 'Elizabeth T Jensen', 'Gianmario Candore', 'Manlik Kwong', 'Julian Gruendner', 'Kristine E Lynch', 'Benjamin S Glicksberg', 'Guan N Guo', 'Ning Shang', 'Andrea Haberson', 'Seo Jeong Shin', 'Benjamin Viernes', 'Himanshu Sharma', 'Jeffrey G Klann', 'Harshana Liyanage', 'Justin Mower', 'Alex Butler', 'Anil Pacaci', 'Christoph Rinner', 'Y X Sun', 'Yuqi Si', 'S T Rosenbloom', 'Toan C Ong', 'Yu Yang', 'Shreya Chakrabarti', 'Werner Ceusters', 'Tian Kang', 'Hyeoneui Kim', 'Maryam Garza', 'Susan Gruber', 'Manfred Hauben', 'Hong Sun', 'F FitzHenry', 'Edeltraut Garbe', 'Yihua Xu', 'Erica A Voss', 'Mohammed Khalilia', 'Peter R Rijnbeek', 'Amy Matcho', 'G Trifiro', 'Rupa Makadia', 'Lian Lian Duan', 'Omolola I Ogunyemi', 'R Harpaz', 'Xiaochun Li', 'Frank J Defalco', 'Xiaofeng Zhou', 'Patrick B Ryan', 'Christian Reich', 'Ryan M Carnahan', 'J Marc Overhage', 'ChulHyoung Park', 'Seung In Seo', 'Eunyoung Lee', 'Seung-Hwa Lee', 'Kyung Ae Lee', 'Elena Roel', 'Jin Young Yoon', 'Alison Callahan', 'Ha Il Kim', 'Chungsoo Kim', 'Sijia Liu', 'Divneet Mandair', 'Ruijun Chen', 'Anandakumar Amutha', 'Christine W Hockett', 'Premanand Tiwari', 'Ruth Brauer', 'Minh Pham', 'Jonathan C Blaisure', 'Abraham G Hartzema', 'Lu Wang', 'Praveen Kumar', 'Marc A Suchard', 'Matthew E Spotnitz', 'Simon Lovestone', 'Chunhua Weng', 'Zhong Yuan', 'Amelia J Averitt', 'Lena Davidson', 'Rachel B Weinstein', 'Chien-Chou Su', 'Talita Duarte-Salles', 'Noha Sharafeldin', 'Tellen D Bennett', 'Nicholas P Giangreco', 'Jean-Francois Ethier', 'Robert M Cronin', 'Simon de Lusignan', 'Zhaobin Kuang', 'Richard A Hansen', 'R W White', 'Paul E Stang', 'David Madigan', 'Xiangmin Ji', 'M Lavallee', 'Xintong Li', 'Ye Ye', 'Joon-Hyop Lee', 'Jill Hardin', 'Chi Yuan', 'Christina Schuttler', 'Jae Hyun Kim', 'Rui Duan', 'Nicholas J Dobbins', 'Patrick Wu', 'Sigfried Gold', 'Tiffany J Callahan', 'Nir Nissim', 'Rae Woong Park', 'Matthias Samwald', 'Michael G Kahn', 'Kristin Kostka', 'Jiaojiao Zhou', 'Jimmy Phuong', 'Jordi Rambla', 'JungHyun Byun', 'Hyesil Jung', 'Daniel R Harris', 'Matthias Hunger', 'Seok Kim', 'Juan C Quiroz', 'Tae-Hoon Kim', 'Franziska Bathelt', 'Daniel Puttmann', 'Kadri Kunnapuu', 'Elisa Henke', 'Jose Manuel Saborit-Torres', 'Emmanuelle Theron', 'Hui Xing Tan', 'Wook Yi', 'Fatemeh Amrollahi', 'Kristina Bardenheuer', 'Katie R Bradwell', 'Won-Woo Seo', 'V Lin', 'Azza Shoaibi', 'Rohan Khera', 'Paul M Heider', 'Lamy Jean-Baptiste', 'Melanie Buy', 'Pareen Vora', 'Sooyoung Yoo', 'Cynthia Yang', 'Anthony Molinaro', 'Gayathri Delanerolle', 'Yae Won Tak', 'Karoline B Brauner', 'Maryam Khodaverdi', 'Rachel E Sobel', 'Ed Whalen', 'Jenna Marie Reps', 'Shawn E Simpson', 'P B Ryan', 'Christopher B Forrest', 'Daniel Fife', 'Wilson D Pace', 'Vibhu Agarwal', 'Christophe G Lambert', 'Trevor R Shaddox', 'Rave Harpaz', 'Ritu Khare', 'Yiting Wang', 'Darmendra Ramcharran', 'Kiyoshi Kubota', 'M Soledad Cepeda', 'Yuxi Tian', 'Edward Chia-Cheng Lai', 'Stephen S Johnston', 'Lorenz A Kapsner', 'Urmila Chandran', 'Kari A Stephens', 'Dong Yun Lee', 'Aurore Nishimwe', 'Suho Jin', 'Howard A Fishbein', 'Seung Min Lee', 'Sun Ah Choi', 'Prakash Bhuyan', 'R P Vogelsang', 'Melissa A Haendel', 'Stephen P Fortin', 'William DuMouchel', 'G Niklas Noren', 'Ivan Zorych', 'Aaron J Katz', 'Lucila Ohno-Machado', 'Shailja C Shah', 'Yilu Fang', 'Luis H John', 'Berta Raventos', 'Chongliang Luo', 'Yuan Lu', 'Graeme J Hankey', 'Jennifer Abbasi', 'Jungchan Park', 'Elsie Gyang Ross', 'David M Kern', 'Rashmie Abeysinghe', 'Benoit L Marteau', 'Guohui Xiao', 'Carina Nina Vorisek', 'Linying Zhang', 'Victor G Castano', 'Akihiko Nishimura', 'Yerim Kim', 'Sunho Choi', 'Song Wang', 'Rory J McCrimmon', 'Johannes A Kroes', 'Suehyun Lee', 'Najia Ahmadi', 'Woo Kyung Bae', 'Lara J Kanbar', 'Tae Kyu Chung', 'Elzo Pereira Pinto Junior', 'Tianchu Lyu', 'Caroline Bonisch', 'Philipp Wegner', 'Xiao Wang', 'Emily Jefferson', 'N Hughes', 'Pradeep A Praveen', 'Joshua J Gagne', 'Veronika Pav', 'Ki-Yeol Park', 'Xiang Cheng', 'Kangah Park', 'Junqing Xie', 'Hao Luo', 'David Moreno-Martos']",126,350,"['Kangah, Park', 'Minsu, Cho', 'Minseok, Song', 'Sooyoung, Yoo', 'Hyunyoung, Baek', 'Seok, Kim', 'Kidong, Kim'], ['Yue, Yu', 'Guoqian, Jiang', 'Eric, Brandt', 'Tom, Forsyth', 'Sanket S, Dhruva', 'Shumin, Zhang', 'Jiajing, Chen', 'Peter A, Noseworthy', 'Amit A, Doshi', 'Kimberly, Collison-Farr', 'Dure, Kim', 'Joseph S, Ross', 'Paul M, Coplan', 'Joseph P Jr, Drozda'], ['Junqing, Xie', 'James T, Brash', 'Cigdem, Turkmen', 'Stefan, Driessen', 'Giustino, Varrassi', 'George, Argyriou', 'Sarah, Seager', 'Christian, Reich', 'Daniel, Prieto-Alhambra'], ['Ines, Reinecke', 'Joscha, Siebel', 'Saskia, Fuhrmann', 'Andreas, Fischer', 'Martin, Sedlmayr', 'Jens, Weidner', 'Franziska, Bathelt'], ['Hao, Luo', 'Wallis C Y, Lau', 'Yi, Chai', 'Carmen Olga, Torre', 'Robert, Howard', 'Kathy Y, Liu', 'Xiaoyu, Lin', 'Can, Yin', 'Stephen, Fortin', 'David M, Kern', 'Dong Yun, Lee', 'Rae Woong, Park', 'Jae-Won, Jang', 'Celine S L, Chui', 'Jing, Li', 'Christian, Reich', 'Kenneth K C, Man', 'Ian C K, Wong']","'Kangah Park', 'Minsu Cho', 'Minseok Song', 'Sooyoung Yoo', 'Hyunyoung Baek', 'Seok Kim', 'Kidong Kim', 'Yue Yu', 'Guoqian Jiang', 'Eric Brandt', 'Tom Forsyth', 'Sanket S Dhruva', 'Shumin Zhang', 'Jiajing Chen', 'Peter A Noseworthy', 'Amit A Doshi', 'Kimberly Collison-Farr', 'Dure Kim', 'Joseph S Ross', 'Paul M Coplan', 'Joseph P Jr Drozda', 'Junqing Xie', 'James T Brash', 'Cigdem Turkmen', 'Stefan Driessen', 'Giustino Varrassi', 'George Argyriou', 'Sarah Seager', 'Christian Reich', 'Daniel Prieto-Alhambra', 'Ines Reinecke', 'Joscha Siebel', 'Saskia Fuhrmann', 'Andreas Fischer', 'Martin Sedlmayr', 'Jens Weidner', 'Franziska Bathelt', 'Hao Luo', 'Wallis C Y Lau', 'Yi Chai', 'Carmen Olga Torre', 'Robert Howard', 'Kathy Y Liu', 'Xiaoyu Lin', 'Can Yin', 'Stephen Fortin', 'David M Kern', 'Dong Yun Lee', 'Rae Woong Park', 'Jae-Won Jang', 'Celine S L Chui', 'Jing Li', 'Christian Reich', 'Kenneth K C Man', 'Ian C K Wong'","['Carlen Reyes', 'Andrea Pistillo', 'Sergio Fernandez-Bertolin', 'Martina Recalde', 'Elena Roel', 'Diana Puente', 'Anthony G Sena', 'Clair Blacketer', 'Lana Lai', 'Thamir M Alshammari', 'Waheed-Ui-Rahman Ahmed', 'Osaid Alser', 'Heba Alghoul', 'Carlos Areia', 'Dalia Dawoud', 'Albert Prats-Uribe', 'Neus Valveny', 'Gabriel de Maeztu', 'Luisa Sorli Redo', 'Jordi Martinez Roldan', 'Inmaculada Lopez Montesinos', 'Lisa M Schilling', 'Asieh Golozar', 'Christian Reich', 'Jose D Posada', 'Nigam Shah', 'Seng Chan You', 'Kristine E Lynch', 'Scott L DuVall', 'Michael E Matheny', 'Fredrik Nyberg', 'Anna Ostropolets', 'George Hripcsak', 'Peter R Rijnbeek', 'Marc A Suchard', 'Patrick Ryan', 'Kristin Kostka', 'Anastasiya Nestsiarovich', 'Jenna M Reps', 'Maura Beaton', 'Xinzhuo Jiang', 'Matthew Spotnitz', 'Stephen R Pfohl', 'Carmen Olga Torre', 'Dong Yun Lee', 'Sang Joon Son', 'Rae Woong Park', 'Ross D Williams', 'Ines Reinecke', 'Michele Zoch', 'Markus Wilhelm', 'Martin Sedlmayr', 'Emanuele Girani', 'Matteo Gabetta', 'Anna Alloni', 'Morena Stuppia', 'Lucia Sacchi', 'Antoine Lamer', 'Osama Abou-Arab', 'Alexandre Bourgeois', 'Adrien Parrot', 'Benjamin Popoff', 'Jean-Baptiste Beuscart', 'Benoit Tavernier', 'Emily R Pfaff', 'Andrew T Girvin', 'Davera L Gabriel', 'Michele Morris', 'Matvey B Palchuk', 'Harold P Lehmann', 'Benjamin Amor', 'Mark Bissell', 'Katie R Bradwell', 'Sigfried Gold', 'Stephanie S Hong', 'Johanna Loomba', 'Amin Manna', 'Julie A McMurry', 'Emily Niehaus', 'Nabeel Qureshi', 'Anita Walden', 'Xiaohan Tanner Zhang', 'Richard L Zhu', 'Richard A Moffitt', 'Melissa A Haendel', 'Christopher G Chute', 'William G Adams', 'Shaymaa Al-Shukri', 'Alfred Anzalone', 'Ahmad Baghal', 'Tellen D Bennett', 'Elmer V Bernstam', 'Brian Bush', 'Thomas R Campion', 'Victor Castro', 'Jack Chang', 'Deepa D Chaudhari', 'Wenjin Chen', 'San Chu', 'James J Cimino', 'Keith A Crandall', 'Mark Crooks', 'Sara J Deakyne Davies', 'John DiPalazzo', 'David Dorr', 'Dan Eckrich', 'Sarah E Eltinge', 'Daniel G Fort', 'George Golovko', 'Snehil Gupta', 'Janos G Hajagos', 'David A Hanauer', 'Brett M Harnett', 'Ronald Horswell', 'Nancy Huang', 'Steven G Johnson', 'Michael Kahn', 'Kamil Khanipov', 'Curtis Kieler', 'Katherine Ruiz De Luzuriaga', 'Sarah Maidlow', 'Ashley Martinez', 'Jomol Mathew', 'James C McClay', 'Gabriel McMahan', 'Brian Melancon', 'Stephane Meystre', 'Lucio Miele', 'Hiroki Morizono', 'Ray Pablo', 'Lav Patel', 'Jimmy Phuong', 'Daniel J Popham', 'Claudia Pulgarin', 'Carlos Santos', 'Indra Neil Sarkar', 'Nancy Sazo', 'Soko Setoguchi', 'Selvin Soby', 'Sirisha Surampalli', 'Christine Suver', 'Uma Maheswara Reddy Vangala', 'Shyam Visweswaran', 'James von Oehsen', 'Kellie M Walters', 'Laura Wiley', 'David A Williams', 'Sara Khalid', 'Cynthia Yang', 'Talita Duarte-Salles', 'Chungsoo Kim', 'Jimyung Park', 'Martijn J Schuemie', 'Edward Burn', 'Paula Casajust', 'Thomas Falconer', 'Mengchun Gong', 'Jennifer C E Lane', 'Paras P Mehta', 'Daniel R Morales', 'Karthik Natarjan', 'Karishma Shah', 'Vignesh Subbian', 'Lin Zhang', 'Hong Zhu', 'Daniel Prieto-Alhambra', 'Zhehuan Chen', 'Hao Liu', 'Alex Butler', 'Vlasios K Dimitriadis', 'George I Gavriilidis', 'William Carter', 'Jitendra Jonnagaddala', 'David Vizcaya', 'Ying Zhang', 'Li Liu', 'Jaehyeong Cho', 'Xu Zuo', 'Jianfu Li', 'Bo Zhao', 'Yujia Zhou', 'Xiao Dong', 'Jon Duke', 'Juan M Banda', 'Ruth Reeves', 'Timothy Miller', 'Chunhua Weng', 'Anthony Molinaro', 'Frank DeFalco', 'Siaw-Teng Liaw', 'Hokyun Jeon', 'George Argyriou', 'Robert Miller', 'Andrew Williams', 'Evan Minty', 'Justin T Reese', 'Ben Coleman', 'Lauren Chan', 'Hannah Blau', 'Tiffany J Callahan', 'Luca Cappelletti', 'Tommaso Fontana', 'Katie Rebecca Bradwell', 'Nomi L Harris', 'Elena Casiraghi', 'Giorgio Valentini', 'Guy Karlebach', 'Rachel Deer', 'Heidi Spratt', 'Jasvinder Singh', 'Christopher J Mungall', 'David Madigan', 'Torunn Elise Sivesind', 'Taylor Runion', 'Megan Branda', 'Eng Hooi Tan', 'Yue Yang', 'Arani Vivekanantham', 'Aaron Abend', 'Adam Wilcox', 'Alan Andryc', 'Chi Young Jung', 'Christopher Harle', 'Gigi Lipori', 'Jason Thomas', 'Jiang Bian', 'Juan P Horcajada', 'Julianna Kohler', 'Nicole Weiskopf', 'Robert Schuff', 'Sarah Seager', 'Seokyoung Song', 'Stephen Fortin', 'Tanja Magoc', 'Vojtech Huser', 'Yin Guan', 'Yankuic Galvan', 'Xing He', 'Aniek F Markus', 'Gowtham Rao', 'Azza Shoaibi', 'Ewout W Steyerberg', 'Benjamin Skov Kaas-Hansen', 'Young Hwa Choi', 'Maria Tereza Fernandes Abrahao', 'Maria Aragon', 'James Weaver', 'Patricia Biedermann', 'Kristina Fister', 'Jill Hardin', 'Laura Hester', 'Sajan Khosla', 'Spyros Kolovos', 'Rupa Makadia', 'Henry Morgan-Stewart', 'Mees Mosseveld', 'Danielle Newby', 'Haini Wen', 'Marcel de Wilde', 'Junqing Xie', 'Simon Lovestone', 'M Soledad Cepeda', 'Jianxiao Yang', 'Yuxi Tian', 'Alejandro Schuler', 'Nicolas H Thurin', 'Regis Lassalle', 'Marine Penichon', 'Joshua J Gagne', 'Jeremy A Rassen', 'Jacques Benichou', 'Alain Weill', 'Patrick Blin', 'Nicholas Moore', 'Pascal S Brandt', 'Richard C Kiefer', 'Jennifer A Pacheco', 'Prakash Adekkanattu', 'Evan T Sholle', 'Faraz S Ahmad', 'Jie Xu', 'Zhenxing Xu', 'Jessica S Ancker', 'Fei Wang', 'Yuan Luo', 'Guoqian Jiang', 'Jyotishman Pathak', 'Jingqi Wang', 'Noor Abu-El-Rub', 'Josh Gray', 'Huy Anh Pham', 'Frank Manion', 'Mei Liu', 'Xing Song', 'Hua Xu', 'Masoud Rouhizadeh', 'Mitchell M Conover', 'Aedin C Culhane', 'Alexander Davydov', 'Dmitry Dymshyts', 'Seamus Kent', 'Christophe G Lambert', 'Johan van der Lei', 'Andrea V Margulis', 'Selva Muthu Kumaran Sathappan', 'Carmen O Torre', 'Oleg Zhuk', 'Christian Gulden', 'Michele Kummel', 'Azadeh Nassirian', 'Romina Blasini', 'Yu Tian', 'Weiguo Chen', 'Tianshu Zhou', 'Jun Li', 'Kefeng Ding', 'Yue Yu', 'Kathryn Ruddy', 'Aaron Mansfield', 'Nansu Zong', 'Andrew Wen', 'Shintaro Tsuji', 'Ming Huang', 'Hongfang Liu', 'Nilay Shah', 'Hamed Abedtash', 'Amanda Alberga', 'Weihua Gao', 'Yonghua Jing', 'Denys Kaduk', 'Yeesuk Kim', 'Hyejin Lee', 'Yeunsook Rho', 'Joel Swerdel', 'Salvatore Volpe', 'Belay B Yimer', 'Jun Chen', 'Fatemah A Alnofal', 'Adel A Alrwisan', 'Alison Callahan', 'Hong-Seok Lim', 'Mehr Kashyap', 'Martin Seneviratne', 'Borim Ryu', 'Sooyoung Yoo', 'Luke V Rasmussen', 'Youn I Choi', 'Yoon Jae Kim', 'Jun-Won Chung', 'Kyoung Oh Kim', 'Hakki Kim', 'Brian E Dixon', 'Chen Wen', 'Tony French', 'Jennifer L Williams', 'Daniel Fife', 'Qiong Wang', 'Yuhui Zou', 'Erica A Voss', 'RuiJun Chen', 'Mui Van Zandt', 'Margarita Fernandez-Chas', 'Rohit Vashisht', 'Suranga N Kasthurirathne', 'Qing Jiang', 'Ning Shang', 'Jiayi Tong', 'Rui Duan', 'Ruowang Li', 'Jason H Moore', 'Victoria L Bartlett', 'Sanket S Dhruva', 'Paul M Heider', 'Youngjun Kim', 'Daniel B Aruch', 'Rimma Belenkaya', 'Michael Gurley', 'Sonia Araujo', 'Paul R Kingsbury', 'Daniel M Lima', 'Jose F Rodrigues-Jr', 'Agma J M Traina', 'Fabio A Pires', 'Peggy L Peissig', 'Cong Liu', 'Barbara Benoit', 'Robert J Carroll', 'David S Carrell', 'Joshua C Denny', 'Ozan Dikilitas', 'Vivian S Gainer', 'Kayla Marie Howell', 'Jeffrey G Klann', 'Iftikhar J Kullo', 'Todd Lingren', 'Frank D Mentch', 'Shawn N Murphy', 'Wei-Qi Wei', 'Ken Wiley', 'Jeremy L Warner', 'Harry Hochheiser', 'Zachary H Moldwin', 'James R Rogers', 'Tian Kang', 'Alan Bauck', 'Ritu Khare', 'Jeffrey S Brown', 'John Weeks', 'James D Brooks', 'Na Hong', 'Kenneth Jung', 'Sanghyung Jin', 'Joel T Dudley', 'Kipp W Johnson', 'Mark M Shervey', 'Yonghui Wu', 'Karthik Natrajan', 'Peng Jin', 'Anthony Reckard', 'Ning Zhang', 'Huawei Wu', 'Shanshan Lu', 'Li Hou', 'Yinying Lu', 'Casey N Ta', 'Michel Dumontier', 'Nicholas P Tatonetti', 'Xin Zhang', 'Li Wang', 'Shumei Miao', 'Yuechuchu Yin', 'Yueshi Zhu', 'Zuolei Dai', 'Tao Shan', 'Shenqi Jing', 'Jian Wang', 'Xiaoliang Zhang', 'Zhongqiu Huang', 'Zhongmin Wang', 'Jianjun Guo', 'Matthew E Levine', 'Peter L Elkin', 'Sarah Mullin', 'David J Albers', 'Hans-Ulrich Prokosch', 'Till Acker', 'Johannes Bernarding', 'Harald Binder', 'Martin Boeker', 'Melanie Boerries', 'Philipp Daumke', 'Thomas Ganslandt', 'Jurgen Hesser', 'Gunther Honing', 'Michael Neumaier', 'Kurt Marquardt', 'Harald Renz', 'Hermann-Josef Rothkotter', 'Carmen Schade-Brittinger', 'Paul Schmucker', 'Jurgen Schuttler', 'Hubert Serve', 'Keywan Sohrabi', 'Fernanda C G Polubriaginof', 'Rami Vanguri', 'Kayla Quinnies', 'Gillian M Belbin', 'Alexandre Yahi', 'Hojjat Salmasian', 'Tal Lorberbaum', 'Victor Nwankwo', 'Patricia Glowe', 'Iuliana Ionita-Laza', 'Mary Simmerling', 'Suzanne Bakken', 'David Goldstein', 'Krzysztof Kiryluk', 'Eimear E Kenny', 'David K Vawdrey', 'C Maier', 'L Lang', 'H Storf', 'P Vormstein', 'R Bieber', 'J Bernarding', 'T Herrmann', 'C Haverkamp', 'P Horki', 'J Laufer', 'F Berger', 'G Honing', 'H W Fritsch', 'J Schuttler', 'T Ganslandt', 'H U Prokosch', 'hommeaux Eri', 'Deepak K Sharma', 'Seongwon Lee', 'Soo-Yeon Cho', 'Hojun Park', 'Sungjae Jung', 'Dukyong Yoon', 'Rosa Gini', 'Alessandro Pasqua', 'Emanuele Carlini', 'Francesco Profili', 'Iacopo Cricelli', 'Patrizio Dazzi', 'Valentina Barletta', 'Paolo Francesconi', 'Francesco Lapi', 'Andrea Donatini', 'Giulia Dal Co', 'Modesta Visca', 'Mariadonata Bellentani', 'Miriam Sturkenboom', 'Robert Moskovitch', 'Aviram Weiss', 'Yoni Halpern', 'David Sontag', 'Marie-Sophie Schwalm', 'Yuriy Khoma', 'Mark Velez', 'Richard D Boyce', 'Levon Utidjian', 'E A Voss', 'R D Boyce', 'P B Ryan', 'J van der Lei', 'P R Rijnbeek', 'Giampiero Mazzaglia', 'Elisa Bianchini', 'Carmelo Montalbano', 'Giuseppe Roberto', 'Claudio Cricelli', 'Steven M Handler', 'Jordan F Karp', 'Subashan Perera', 'Anando Sen', 'Shreya Chakrabarti', 'Andrew Goldstein', 'Shuang Wang', 'Adler Perotte', 'Daniella Meeker', 'Nicole Pratt', 'Edoardo Vacchi', 'Massimo Coppola', 'Walter Cazzola', 'Preciosa Coloma', 'Roberto Berni', 'Gayo Diallo', 'Jose Luis Oliveira', 'Paul Avillach', 'Gianluca Trifiro', 'Niek Klazinga', 'Eun Kyoung Ahn', 'Man Young Park', 'Dahye Shin', 'Mary Regina Boland', 'Alexandra Jacunski', 'Joseph D Romano', 'Ian Chi Kei Wong', 'G Niklas Noren', 'Yu-Chuan Li', 'Paul E Stang', 'Ying Li', 'Ying Wei', 'Santiago Vilar', 'Zachary Shahn', 'S Vilar', 'D Madigan', 'P E Stang', 'M J Schuemie', 'C Friedman', 'N P Tatonetti', 'Rave Harpaz', 'J Marc Overhage', 'Abraham G Hartzema', 'Mark Khayter', 'Sooin Choi', 'Soo Jeong Choi', 'Jin Kuk Kim', 'Ki Chang Nam', 'Suehyun Lee', 'Ju Han Kim', 'Nicolas Paris', 'Miguel Pedrera', 'Noelia Garcia', 'Paula Rubio', 'Juan Luis Cruz', 'Jose Luis Bernal', 'Francesca Polce', 'Giordano Lanzola', 'Enea Parimbelli', 'Yongseok Mun', 'Da Yun Lee', 'Seok Kim', 'Yoo-Ri Chung', 'Kihwang Lee', 'Ji Hun Song', 'Young Gun Park', 'Young Hoon Park', 'Young-Jung Roh', 'Se Joon Woo', 'Kyu Hyung Park', 'Dong-Jin Chang', 'Rose Ong', 'Alexandra Orlova', 'Philip Solovyev', 'Hong Sun', 'Graham Wetherill', 'Monika Brand', 'William A Wood', 'Peter Marks', 'Robert M Plovnick', 'Kathleen Hewitt', 'Donna S Neuberg', 'Sam Walters', 'Brendan K Dolan', 'Emily A Tucker', 'Charles S Abrams', 'Alexis A Thompson', 'Kenneth C Anderson', 'Paul Kluetz', 'Ann Farrell', 'Donna Rivera', 'Matthew Gertzog', 'Yuan Peng', 'Najia Ahmadi', 'Vaclav Papez', 'Maxim Moinat', 'Stefan Payralbe', 'Folkert W Asselbergs', 'R Thomas Lumbers', 'Harry Hemingway', 'Richard Dobson', 'Xinhang Li', 'Fabricio Kury', 'Chi Yuan', 'Yingcheng Sun', 'Young Seok Jeon', 'Trung Kien Dang', 'Su Chi Lim', 'Yi-Ming Shao', 'E Shyong Tai', 'Jin Ge', 'Mark J Pletcher', 'Joao Rafael Almeida', 'Joao Figueira Silva', 'Sergio Matos', 'Christophe Gaudet-Blavignac', 'Jean Louis Raisaro', 'Vasundra Toure', 'Sabine Osterle', 'Katrin Crameri', 'Lee Christensen', 'Jeremiah R Brown', 'Michael Conway', 'Maxwell Levis', 'Glenn T Gobbel', 'Rashmee U Shah', 'Christine Goodrich', 'Iben Ricket', 'Freneka Minter', 'Andrew Bohm', 'Bruce E Bray', 'Tarun Karthik Kumar Mamidi', 'Thi K Tran-Nguyen', 'Ryan L Melvin', 'Junghwan Lee', 'Jae Hyun Kim', 'Chao Pang', 'Gyu Lee Kim', 'Yu Hyeon Yi', 'Hye Rim Hwang', 'Jinmi Kim', 'Youngmin Park', 'Yun Jin Kim', 'Jeong Gyu Lee', 'Young Jin Tak', 'Seung Hun Lee', 'Sang Yeoup Lee', 'Youn Hye Cho', 'Eun Ju Park', 'SeHee Oh', 'MinDong Sung', 'Yumie Rhee', 'Namki Hong', 'Raphael W Majeed', 'Patrick Fischer', 'Mark R Stohr', 'Eugenia Rinaldi', 'Fabio Boudis', 'Guillaume Clement', 'Amelie Bruandet', 'Christian Gierschner', 'Mirko Gruhl', 'Liz A Leutner', 'Hyunah Shin', 'Leslie A Lenert', 'Andrey V Ilatovskiy', 'James Agnew', 'Patricia Rudisill', 'Jeff Jacobs', 'Duncan Weatherston', 'Byungkon Kang', 'Jisang Yoon', 'Ha Young Kim', 'Sung Jin Jo', 'Yourim Lee', 'Anusha Bompelli', 'Yiqi Xu', 'Nan Wang', 'Yanshan Wang', 'Terrence Adam', 'Zhe He', 'Latoya A Stewart', 'Christopher T Southard', 'Eugene Jeong', 'Dongsu Park', 'Jin Roh', 'Jae Youn Cheong', 'Jin Wook Choi', 'Mira Kang', 'Jeong-Whun Kim', 'Wongeun Song', 'Ho-Young Lee', 'Seok Yun Kang', 'Seung In Seo', 'Yeonchan Seong', 'Yunjung Heo', 'Christian Maier', 'Lorenz A Kapsner', 'Sebastian Mate', 'Shilpa Ratwani', 'Anastasios Siapos', 'Vladislav Korsik', 'W Scott Campbell', 'Tatiana Banokina', 'Elizaveta Modina', 'Shantha Bethusamy', 'Meera Patel', 'Soe Jeong Shin', 'Kees van Bochove', 'Cynthia Sung', 'Harlan M Krumholz', 'Pall Jonsson', 'Jens Torup Ostby', 'Nigel Hughes', 'Eunsil Yoon', 'Sejoon Lee', 'Hyunyoung Baek', 'Soyoung Yi', 'Hee Young Na', 'Ji-Won Kim', 'Rong-Min Baek', 'Hee Hwang', 'Francesc Xavier Aviles-Jurado', 'Otavio T Ranzani', 'Seungho Jeon', 'Jeongeun Seo', 'Sukyoung Kim', 'Jeongmoon Lee', 'Jong-Ho Kim', 'Jang Wook Sohn', 'Jongsub Moon', 'Bumhee Park', 'Sylvia Cho', 'Margaret Sin', 'Demetra Tsapepas', 'Leigh-Anne Dale', 'Syed A Husain', 'Sumit Mohan', 'Gabriel A Brat', 'Griffin M Weber', 'Nils Gehlenborg', 'Nathan P Palmer', 'Luca Chiovato', 'Lemuel R Waitman', 'Gilbert S Omenn', 'Alberto Malovini', 'Brett K Beaulieu-Jones', 'Valentina Tibollo', 'Christel Daniel', 'Shorabuddin Syed', 'Fred Prior', 'Meredith Zozus', 'Hafsa Bareen Syeda', 'Maryam Garza', 'Salma Begum', 'Kim Gates', 'Mahanazuddin Syed', 'Henning Gall', 'Achim Michel-Backofen', 'Philipp Unberath', 'Julian Grundner', 'Marcel Erpenbeck', 'Chelsea L Michael', 'Regina T Wulff', 'Gail J Roboz', 'Hunmin Kim', 'Yonghoon Jeon', 'Sun Ah Choi', 'Hyerim Ji', 'Elizabeth T Jensen', 'Dana A Dabelea', 'Pradeep A Praveen', 'Anandakumar Amutha', 'Christine W Hockett', 'Scott P Isom', 'Toan C Ong', 'Viswanathan Mohan', 'Agostino Ralph J', 'Gianmario Candore', 'Karin Hedenmalm', 'Jim Slattery', 'Alison Cave', 'Xavier Kurz', 'Nicolas Depas', 'Matthieu Doutreligne', 'David Verloop', 'Marguerite-Marie Defebvre', 'Gregoire Ficheur', 'Emmanuel Chazard', 'Manlik Kwong', 'Heather L Gardner', 'Neil Dieterle', 'Thorsten Schwachhofer', 'Phillip Sippl', 'Nicolas Wolf', 'Jakob Zierk', 'Michael Sturzl', 'Roland Croner', 'Stephen A Deppen', 'Benjamin Viernes', 'Aize Cao', 'Daniel Park', 'Elizabeth Hanchrow', 'Kushan Hewa', 'Peter Greaves', 'Benjamin S Glicksberg', 'Boris Oskotsky', 'Nicholas Giangreco', 'Phyllis M Thangaraj', 'Vivek Rudrapatna', 'Debajyoti Datta', 'Remi Frazier', 'Nelson Lee', 'Rick Larsen', 'Guan N Guo', 'Sanjay Farshid', 'Hakon Hakonarson', 'Theresa L Walunas', 'Andrea Haberson', 'Christoph Rinner', 'Alexander Schoberl', 'Seo Jeong Shin', 'Yu Rang Park', 'Brett South', 'Gregorio Coronado', 'Marcus A Badgeley', 'Nadav Rappoport', 'Riccardo Miotto', 'Theodore C Goldstein', 'Eugenia Rutenberg', 'Sharat Israni', 'Bethany Percha', 'Himanshu Sharma', 'Chengsheng Mao', 'Yizhen Zhang', 'Haleh Vatani', 'Liang Yao', 'Yizhen Zhong', 'Jang-Hee Kim', 'Seokjin Haam', 'Dae-Soon Son', 'Seungbin Oh', 'Matthew A H Joss', 'Kevin Embree', 'Harshana Liyanage', 'William Hinton', 'Lori C Phillips', 'Christopher Herrick', 'Kavishwar B Wagholikar', 'Justin Mower', 'Devika Subramanian', 'Yuqi Si', 'Anil Pacaci', 'Suat Gonul', 'A Anil Sinaci', 'Mustafa Yuksel', 'Deniz Gezgin', 'Christopher Wendl', 'Y X Sun', 'Z C Pei', 'S T Rosenbloom', 'R J Carroll', 'J L Warner', 'M E Matheny', 'Bethany M Kwan', 'Traci Yamashita', 'Elias Brandt', 'Patrick Hosokawa', 'Chris Uhrich', 'Yu Yang', 'Xiaofeng Zhou', 'Shuangqing Gao', 'Hongbo Lin', 'Yanming Xie', 'Yuji Feng', 'Kui Huang', 'Gregory W Hruby', 'Alexander Rusanov', 'Werner Ceusters', 'Shaodian Zhang', 'Youlan Tang', 'Noemie Elhadad', 'Hyeoneui Kim', 'Jeeyae Choi', 'Imho Jang', 'Jimmy Quach', 'Guilherme Del Fiol', 'Jessica Tenenbaum', 'Susan Gruber', 'Aloka Chakravarty', 'Susan R Heckbert', 'Mark Levenson', 'David Martin', 'Jennifer C Nelson', 'Bruce M Psaty', 'Simone Pinheiro', 'Sengwee Toh', 'Manfred Hauben', 'Jeffrey K Aronson', 'Kristof Depraetere', 'Jos De Roo', 'Giovanni Mels', 'Boris De Vloed', 'Marc Twagirumukiza', 'F FitzHenry', 'F S Resnic', 'S L Robbins', 'J Denton', 'L Nookala', 'D Meeker', 'L Ohno-Machado', 'Edeltraut Garbe', 'Yihua Xu', 'Brandon T Suehs', 'Yola Moride', 'Brian C Sauer', 'Qing Liu', 'Keran Moll', 'Margaret K Pasquale', 'Vinit P Nair', 'Qianli Ma', 'Amy Matcho', 'Chris Knoll', 'Ajit Londhe', 'Vivienne Zhu', 'Mohammed Khalilia', 'Myung Choi', 'Amelia Henderson', 'Sneha Iyengar', 'Mark Braunstein', 'G Trifiro', 'P M Coloma', 'S Romio', 'B Mosseveld', 'D Weibel', 'J Bonhoeffer', 'Lian Lian Duan', 'Mohammad Khoshneshin', 'W Nick Street', 'Huub Straatman', 'Ron M C Herings', 'Lars Pedersen', 'Francesco Innocenti', 'Gino Picelli', 'Omolola I Ogunyemi', 'Naveen Ashish', 'Seena Farzaneh', 'R Harpaz', 'W DuMouchel', 'P LePendu', 'A Bauer-Mehren', 'Xiaochun Li', 'Siu Hui', 'Marc Rosenman', 'Sundaresan Murugesan', 'Harshvinder Bhullar', 'Bing Cai', 'Chuck Wentworth', 'Judith A Racoosin', 'Ryan M Carnahan', 'ChulHyoung Park', 'Chang Won Jeong', 'Chan Hyuk Park', 'Tae Jun Kim', 'Chang Seok Bang', 'Jae Young Kim', 'Kyung Joo Lee', 'Jinseob Kim', 'Hyon Hee Kim', 'Eunyoung Lee', 'Helmet Karim', 'Carmen Andreescu', 'Akiko Mizuno', 'Howard Aizenstein', 'Heirim Lee', 'Kyungmin Lee', 'Sun-Mi Cho', 'Doyeop Kim', 'Seung-Hwa Lee', 'Kwang Jin Chun', 'Jungchan Park', 'Ji Dong Sung', 'Kyung Ae Lee', 'Heung Yong Jin', 'Yu Ji Kim', 'Yong-Jin Im', 'Eun-Young Kim', 'Ibrahim Diallo', 'Isabelle Soerjomataram', 'Yang Shen', 'Annalisa Trama', 'Jin Young Yoon', 'Jae Myung Cha', 'Ha Il Kim', 'Vladimir Polony', 'Saurabh Gombar', 'Min Seob Kwak', 'Sijia Liu', 'Liwei Wang', 'Feichen Shen', 'Steven Bedrick', 'William Hersh', 'Divneet Mandair', 'Premanand Tiwari', 'Steven Simon', 'Kathryn L Colborn', 'Katherine D Crew', 'Gurvaneet Randhawa', 'Agostino Ralph B J', 'Tae Joon Kim', 'You Sang Ko', 'Yerim Kim', 'Jong Jin Yoo', 'Derek E Smith', 'Fuyong Xing', 'Debashis Ghosh', 'Ruth Brauer', 'Kenneth Kc Man', 'Usman Iqbal', 'Phung-Anh Alex Nguyen', 'Minh Pham', 'Feng Cheng', 'Jonathan C Blaisure', 'Emily Welebob', 'Jesse A Berlin', 'Ian C K Wong', 'Lu Wang', 'Zhong Yuan', 'Don Sun', 'Amy Freedman', 'Maria Alba', 'Joan Lind', 'Gary Meininger', 'Praveen Kumar', 'Stuart J Nelson', 'Berit Kerner', 'Douglas J Perkins', 'Steven Shea', 'Rose Qiu', 'Jacqueline Yee', 'Amelia J Averitt', 'Lena Davidson', 'Rachel B Weinstein', 'Natnicha Vanitchanant', 'Rajesh Ranganath', 'Chien-Chou Su', 'Edward Chia-Cheng Lai', 'Yea-Huei Kao Yang', 'Kiyoshi Kubota', 'Chantelle Hardy', 'Yinghong Zhang', 'Shinya Kimura', 'Yukari Kamijima', 'Alana Cuthbert', 'Pablo Iveli', 'Noha Sharafeldin', 'Benjamin Bates', 'Qianqian Song', 'Vithal Madhira', 'Yao Yan', 'Sharlene Dong', 'Eileen Lee', 'Nathaniel Kuhrt', 'Yu Raymond Shao', 'Feifan Liu', 'Timothy Bergquist', 'Justin Guinney', 'Jing Su', 'Adit Anand', 'Carolyn Bremer', 'James Brian Byrd', 'Alina Denham', 'Peter E DeWitt', 'Brian T Garibaldi', 'Elaine L Hill', 'Hunter Jimenez', 'Ramakanth Kavuluru', 'Eli Levitt', 'Sandeep K Mallipattu', 'John Muschelli', 'Andrew J Neumann', 'Zhenglong Qian', 'Seth Russell', 'Jacob T Wooldridge', 'Yun Jae Yoo', 'Christopher P Austin', 'Joel H Saltz', 'Ken R Gersing', 'Jean-Francois Ethier', 'Francois Goyer', 'Paul Fabry', 'Robert M Cronin', 'Alese E Halvorson', 'Cassie Springer', 'Xiaoke Feng', 'Lina Sulieman', 'Roxana Loperena-Cortes', 'Kelsey Mayo', 'Qingxia Chen', 'Brian K Ahmedani', 'Jason Karnes', 'Bruce Korf', 'Donnell Christopher ', 'Simon de Lusignan', 'Nicholas Jones', 'Jienchi Dorward', 'Rachel Byford', 'John Briggs', 'Filipa Ferreira', 'Oluwafunmi Akinyemi', 'Gayatri Amirthalingam', 'Chris Bates', 'Jamie Lopez Bernal', 'Gavin Dabrera', 'Alex Eavis', 'Alex J Elliot', 'Michael Feher', 'Else Krajenbrink', 'Uy Hoang', 'Gary Howsam', 'Jonathan Leach', 'Cecilia Okusi', 'Brian Nicholson', 'Philip Nieri', 'Julian Sherlock', 'Gillian Smith', 'Mark Thomas', 'Nicholas Thomas', 'Manasa Tripathy', 'William Victor', 'John Williams', 'Ian Wood', 'Maria Zambon', 'John Parry', 'Hanlon Shau', 'Zhaobin Kuang', 'Vitor Santos Costa', 'Richard Maclin', 'Richard A Hansen', 'Peng Zeng', 'Juan Gao', 'Kalyani Sonawane', 'Benjamin Teeter', 'Kimberly Westrich', 'R W White', 'N H Shah', 'Zach Shahn', 'William DuMouchel', 'Daniel J Stone', 'David Knaack', 'Alanna M Chamberlain', 'Xiangmin Ji', 'Guimei Cui', 'Chengzhen Xu', 'Jie Hou', 'Yunfei Zhang', 'M Lavallee', 'T Yu', 'L Evans', 'M Van Hemelrijck', 'C Bosco', 'A Golozar', 'Min Ho An', 'Iannis Drakos', 'Prasanna L Kandukuri', 'Jan A Kors', 'Gerardo Machnicki', 'Marcela Rivera', 'Tom Seinen', 'Lili Zhou', 'Xintong Li', 'Faaizah Arshad', 'Ye Ye', 'Seemran Barapatre', 'Michael K Davis', 'Keith O Elliston', 'Christos Davatzikos', 'Andrey Fedorov', 'Jean-Christophe Fillion-Robin', 'Ian Foster', 'John R Gilbertson', 'Andras Lasso', 'James V Miller', 'Martin Morgan', 'Steve Pieper', 'Brigitte E Raumann', 'Brion D Sarachan', 'Guergana Savova', 'Jonathan C Silverstein', 'Donald P Taylor', 'Joyce B Zelnis', 'Guo-Qiang Zhang', 'Jamie Cuticchia', 'Yong Chen', 'Joon-Hyop Lee', 'Suhyun Kim', 'Kwangsoo Kim', 'Young Jun Chai', 'Hyeong Won Yu', 'Su-Jin Kim', 'June Young Choi', 'Yoo Seung Chung', 'Kyu Eun Lee', 'Ziran Li', 'Christina Schuttler', 'Lyudmila Ena', 'Shing M Lee', 'Mitchell S V Elkind', 'Behnood Bikdeli', 'Jiwoo Kim', 'Aakriti Gupta', 'Chongliang Luo', 'C Jason Liang', 'Howard H Chang', 'John H Holmes', 'Christopher B Forrest', 'Sally C Morton', 'Kevin B Mahoney', 'Nicholas J Dobbins', 'Clifford H Spital', 'Robert A Black', 'Jason M Morrison', 'Bas de Veer', 'Elizabeth Zampino', 'Robert D Harrington', 'Bethene D Britt', 'Kari A Stephens', 'Peter Tarczy-Hornoch', 'Patrick Wu', 'Aliya Gifford', 'Xiangrui Meng', 'Xue Li', 'Harry Campbell', 'Tim Varley', 'Juan Zhao', 'Lisa Bastarache', 'Evropi Theodoratou', 'Andrea Batch', 'Robert McClure', 'Hadi Kharrazi', 'Rishi Saripalle', 'Nancy Roderer', 'Ana Szarfman', 'Niklas Elmqvist', 'David Bertoch', 'Jeff Brown', 'Jenny Staab', 'Pradipta Parhi', 'Donahue Smith', 'Sean Mooney', 'Josh Denny', 'Pierre Gentine', 'Nir Nissim', 'Yuval Shahar', 'Yuval Elovici', 'Konrad J Karczewski', 'Matthias Samwald', 'Hong Xu', 'Kathrin Blagec', 'Philip E Empey', 'Daniel C Malone', 'Seid Mussa Ahmed', 'Sebastian Hofer', 'Dong Ki Kim', 'Eun-Young Jung', 'Dong Kyun Park', 'Yeonsoo Hwang', 'Alein T Chun', 'Bruce N Davidson', 'Adam Lee', 'Eugenia Martinez-Hernandez', 'Edelmira Marti', 'Antonella Delmestri', 'Katia Verhamme', 'Scott Horban', 'Sang Soo Kim', 'Eun-Hee Cho', 'Dae Jung Kim', 'Hiba Alghoul', 'Victor G Castano', 'Genna J Waldman', 'Michael Argenziano', 'Ruth Ottman', 'Hyunmi Choi', 'Jiaojiao Zhou', 'Chengwei Guo', 'Li Ren', 'Dandi Zhu', 'Wenfeng Zhen', 'Saina Zhang', 'Juan Espinoza', 'Charisse Madlock-Brown', 'Jordi Rambla', 'Michael Baudis', 'Roberto Ariosa', 'Tim Beck', 'Lauren A Fromont', 'Arcadi Navarro', 'Rahel Paloots', 'Manuel Rueda', 'Gary Saunders', 'Babita Singh', 'John D Spalding', 'Juha Tornroos', 'Claudia Vasallo', 'Colin D Veal', 'JungHyun Byun', 'Hak Young Rhee', 'Ki Won Moon', 'Jeongwon Heo', 'Yoonki Hong', 'Woo Jin Kim', 'Seung-Joo Nam', 'Hoon Sung Choi', 'Ji In Park', 'In Kook Chun', 'So Hyeon Bak', 'Kyoungyul Lee', 'Gi Hwan Byeon', 'Kyoung Lae Kim', 'Jeong-Ah Kim', 'Young Joo Park', 'Jeong Hyun Kim', 'Eun Ju Lee', 'Sang-Ah Lee', 'Sung Ok Kwon', 'Sang-Won Park', 'Payam Hosseinzadeh Kasani', 'Jung-Kyeom Kim', 'Yeshin Kim', 'Seongheon Kim', 'Hyesil Jung', 'Eunjeong Heo', 'Borham Kim', 'Matthias Hunger', 'Kristina Bardenheuer', 'Alun Passey', 'Rene Schade', 'Ruchika Sharma', 'Ji-In Bang', 'Dachung Boo', 'In Young Choi', 'SooJeong Ko', 'Ie Ryung Yoo', 'Junmo Kim', 'YoungHwan Joo', 'Hyun Gee Ryoo', 'Jin Chul Paeng', 'Jung Mi Park', 'Woncheol Jang', 'Byungwon Kim', 'Yangha Chung', 'Dongyoon Yang', 'Juan C Quiroz', 'Tim Chard', 'Zhisheng Sa', 'Angus Ritchie', 'Louisa Jorm', 'Tae-Hoon Kim', 'SiHyeong Noh', 'Youe Ree Kim', 'ChungSub Lee', 'Ji Eon Kim', 'Franziska Bathelt', 'Elisa Henke', 'Jens Weidner', 'Martin Bartos', 'Robert Gott', 'Dagmar Waltemath', 'Katrin Engelmann', 'Peter Eh Schwarz', 'Michael Kallfelz', 'Joscha Siebel', 'Daniel Puttmann', 'Nicolette De Keizer', 'Ronald Cornet', 'Eric Van Der Zwan', 'Abhishek Bhatia', 'Ian M Brooks', 'Jonathan P Dekermanjian', 'Sarah Elizabeth Jolley', 'Kadri Kunnapuu', 'Solomon Ioannou', 'Kadri Ligi', 'Raivo Kolde', 'Sven Laur', 'Jaak Vilo', 'Jose Manuel Saborit-Torres', 'Silvia Nadal-Almela', 'Joaquim Angel Montell-Serrano', 'Elena Oliver-Garcia', 'Hector Carceller', 'Jon Ander Gomez-Adrian', 'Marisa Caparros-Redondo', 'Francisco Garcia-Garcia', 'Julio Domenech-Fernandez', 'Emmanuelle Theron', 'Jean-Francois Gorse', 'W Ray Kim', 'Jennifer C Lai', 'Hui Xing Tan', 'Desmond Chun Hwee Teo', 'Jing Wei Neo', 'Haroun Chahed', 'Pei San Ang', 'Doreen Su Yin Tan', 'Wook Yi', 'Bo Hyun Kim', 'Mijin Kim', 'Myungsoo Im', 'Soree Ryang', 'Eun Heui Kim', 'Yun Kyung Jeon', 'Fatemeh Amrollahi', 'Supreeth P Shashikumar', 'Angela Meier', 'Lucila Ohno-Machado', 'Shamim Nemati', 'Michel Van Speybroeck', 'Clare Hague', 'Enkeleida Nikai', 'Won-Woo Seo', 'Woon Geon Shin', 'Kyung-Jin Kim', 'Sang Youl Rhee', 'Meeyoung Park', 'Eun-Sun Jin', 'V Lin', 'A Tsouchnika', 'E Allakhverdiiev', 'A W Rosen', 'M Gogenur', 'J S R Clausen', 'K B Brauner', 'J S Walbech', 'I Drakos', 'Miguel Angel Mayer', 'Juan Manuel Ramirez-Anguita', 'Filip Maljkovic', 'Biljana Carevic', 'Clement Fraboulet', 'Tanguy Le Carrour', 'Spiros Denaxas', 'Luis H John', 'Rohan Khera', 'Yuan Lu', 'Ronak M Pipaliya', 'Lamy Jean-Baptiste', 'Abdelmalek Mouazer', 'Karima Sedki', 'Melanie Buy', 'William Digan', 'Xiaoyi Chen', 'Julien Husson', 'Mickael Menager', 'Frederic Rieux-Laucat', 'Pareen Vora', 'Beth Russell', 'Alex Asiimwe', 'Sun Jung Lee', 'Eunhye Song', 'Tong Min Kim', 'Ki Won Jin', 'Donghyun Jee', 'Jin-Woo Kwon', 'Emily S Brouwer', 'Loreto Carmona', 'Katerina Chatzidionysiou', 'Walid Fakhouri', 'Antje Hottgenroth', 'Meghna Jani', 'Lembe Kullamaa', 'Karine Marinier', 'Alexander Michel', 'Sulev Reisberg', 'Martin Pinnau', 'Fatma Betul Altun', 'Michael Folz', 'Gayathri Delanerolle', 'Robert Williams', 'Ana Stipancic', 'Anna Forbes', 'Ruby S M Tsang', 'Sneha N Anand', 'Declan Bradley', 'Siobhan Murphy', 'Ashley Akbari', 'Stuart Bedston', 'Ronan A Lyons', 'Rhiannon Owen', 'Fatemeh Torabi', 'Jillian Beggs', 'Antony Chuter', 'Dominique Balharry', 'Mark Joy', 'Aziz Sheikh', 'F D Richard Hobbs', 'Yae Won Tak', 'Jeong Hyun Han', 'Gi-Tae Kim', 'Saberi Rana Ali', 'Arun Singh', 'Karoline B Brauner', 'Andreas W Rosen', 'Adamantia Tsouchnika', 'Julie S Walbech', 'Mikail Gogenur', 'Viviane A Lin', 'Johan S R Clausen', 'Galina Lozinski', 'Maryam Khodaverdi', 'Bradley S Price', 'J Zachary Porterfield', 'H Timothy Bunnell', 'Michael T Vest', 'Jeremy Harper', 'Wes D Kimble', 'Hamidreza Moradi', 'Brian Hendricks', 'Susan L Santangelo', 'Mouhamed Djahoum Moussa', 'Romaric Marcilly', 'Regis Logier', 'Benoit Vallet', 'Rachel E Sobel', 'William Blackwell', 'David M Fram', 'Ed Whalen', 'Warren Bao', 'Mike Gaffney', 'Rongjun Shen', 'Sarah Young', 'Jenna Marie Reps', 'Jonathan M Garibaldi', 'Uwe Aickelin', 'Jack E Gibson', 'Justin Neil Matthews', 'David Prieto-Merino', 'Mariam Molokhia', 'Lorenza Scotti', 'Marsha A Raebel', 'Jason M Glanz', 'Karen Riedlinger', 'Shawn E Simpson', 'Ivan Zorych', 'Peter A Margolis', 'L Charles Bailey', 'Keith Marsolo', 'Mark A Del Beccaro', 'Jonathan A Finkelstein', 'David E Milov', 'Veronica J Vieland', 'Bryan A Wolf', 'Feliciano B Yu', 'Grace Levy-Clarke', 'Wilson D Pace', 'Chester H Fox', 'Turner White', 'Deborah Graham', 'David Hough', 'Vibhu Agarwal', 'Tanya Podchiyska', 'Veena Goel', 'Tiffany I Leung', 'Timothy E Sweeney', 'Elsie Gyang', 'Aurelien J Mazurie', 'Nicolas R Lauve', 'Nathaniel G Hurwitz', 'S Stanley Young', 'Robert L Obenchain', 'Nicolas W Hengartner', 'Mauricio Tohen', 'Trevor R Shaddox', 'Lee Evans', 'Olivier Bodenreider', 'Carol Friedman', 'Eric Horvitz', 'Anna Ripple', 'Alfred Sorbello', 'Ryen W White', 'Rainer Winnenburg', 'Guohua Pan', 'Daniel Yannicelli', 'Juliana Barnard', 'Laura Helmkamp', 'Julie Maertens', 'Byron J Ruth', 'Evanette Burrows', 'Nandan Patibandla', 'Hanieh Razzaghi', 'Ryan Colvin', 'Daksha Ranade', 'Melody Kitzmiller', 'Daniel Eckrich', 'Yiting Wang', 'Mehul Desai', 'Kayur Patel', 'Darmendra Ramcharran', 'Hong Qiu', 'Dina Gifkins', 'Syed Ali Husain', 'Annette S Crisanti', 'Ronald L Krall', 'John B Buse', 'Stephen S Johnston', 'John M Morton', 'Iftekhar Kalsekar', 'Eric M Ammann', 'Chia-Wen Hsiao', 'Marvin O Kampf', 'Susanne A Seuchter', 'Gaetan Kamdje-Wabo', 'Tobias Gradinger', 'Detlef Kraska', 'Urmila Chandran', 'Ashish Sarraju', 'Fahim Abbasi', 'Justin Parizo', 'Mitchel Pariani', 'Hannah Ison', 'Elinor Briskin', 'Hannah Wand', 'Sebastien Dubois', 'Seth A Myers', 'Daniel J Rader', 'Joseph B Leader', 'Michael F Murray', 'Kelly D Myers', 'Katherine Wilemon', 'Yixuan Guo', 'Andrea Wells Shapiro', 'Monika M Safford', 'Shaun Smith', 'Imara I West', 'Kevin A Hallgren', 'Brenda Mollis', 'Kris Ma', 'Dennis M Donovan', 'Brenda Stuvek', 'Chang Hyung Hong', 'Hyun Woong Rho', 'Aurore Nishimwe', 'Charles Ruranga', 'Clarisse Musanabaganwa', 'Regine Mugeni', 'Muhammed Semakula', 'Joseph Nzabanita', 'Ignace Kabano', 'Annie Uwimana', 'Jean N Utumatwishima', 'Jean Damascene Kabakambira', 'Annette Uwineza', 'Lars Halvorsen', 'Freija Descamps', 'Jared Houghtaling', 'Benjamin Burke', 'Odile Bahati', 'Clement Bizimana', 'Stefan Jansen', 'Celestin Twizere', 'Kizito Nkurikiyeyezu', 'Francine Birungi', 'Sabin Nsanzimana', 'Suho Jin', 'Sungwon Roh', 'Young-Hyo Lim', 'Sun Geu Chae', 'Uram Jin', 'Howard A Fishbein', 'Rebecca Jeffries Birch', 'Sunitha M Mathew', 'Holly L Sawyer', 'Gerald Pulver', 'Jennifer Poling', 'David Kaelber', 'Russell Mardon', 'Maurice C Johnson', 'Keith D Umbel', 'Xuanping Zhang', 'Karen R Siegel', 'Giuseppina Imperatore', 'Sundar Shrestha', 'Krista Proia', 'Yiling Cheng', 'Kai McKeever Bullard', 'Edward W Gregg', 'Deborah Rolka', 'Seung Min Lee', 'Jihoon Yoon', 'Sue K Park', 'Sungji Moon', 'Sang Eun Lee', 'JiSeon Oh', 'Kwang-Il Kim', 'Hyung-Jin Yoon', 'Prakash Bhuyan', 'Jennie Medin', 'Hugo Gomes da Silva', 'Madhavi Yadavalli', 'Nirmal Kumar Shankar', 'Hana Mullerova', 'Matthew Arnold', 'R Karl Knight', 'R P Vogelsang', 'R D Bojesen', 'E R Hoelmich', 'A Orhan', 'F Buzquurz', 'L Cai', 'C Grube', 'J A Zahid', 'H H Raskov', 'N Derian', 'Cristian Tebe', 'David A Eichmann', 'Warren A Kibbe', 'Philip R O Payne', 'Peter N Robinson', 'John Wilbanks', 'Chunlei Wu', 'Robert L Bradford', 'Marshall Clark', 'Evan W Colmenares', 'Patricia A Francis', 'Alexis Graves', 'Raju Hemadri', 'George Hripscak', 'Dazhi Jiao', 'Lora Lingrey', 'Usman Sheikh', 'Harold Solbrig', 'Michael G Kurilla', 'Sam G Michael', 'Lili M Portilla', 'Joni L Rutter', 'Brendan Weiss', 'Philip Zachariah', 'Ying Kuen Cheung', 'Stephen Patrick Fortin', 'David M Kern', 'Tomas Bergvall', 'Kristina Juhlin', 'Sarah Valentine', 'Aaron J Katz', 'Zia Agha', 'Douglas S Bell', 'Lisa Dahm', 'Michele E Day', 'Jason N Doctor', 'Maninder K Kahlon', 'Katherine K Kim', 'Michael Hogarth', 'Peter Rjinbeek', 'Joe Posada', 'Thamer Alshammary', 'Menchung Gong', 'Martijn Scheumie', 'Shailja C Shah', 'Andrew Canakis', 'Chad Dorn', 'Otis Wilson', 'Jason Denton', 'Richard Hauger', 'Christine Hunt', 'Ayako Suzuki', 'Edward Siew', 'Adriana Hung', 'Robert A Jr Greevy', 'Md Nazmul Islam', 'Natalie E Sheils', 'John Buresh', 'Mackenzie Edmondson', 'Peter A Merkel', 'Ebbing Lautenbach', 'Azza Shaoibi', 'Yilu Fang', 'Betina Idnay', 'Karen Marder', 'Rebecca Schnall', 'Berta Raventos', 'Anna Berenguera', 'Constanza Jacques-Avino', 'Laura Medina-Perucha', 'Arielle Marks-Anglin', 'Zhaoyi Chen', 'Jalpa A Doshi', 'Rachel M Werner', 'David A Asch', 'Yun Liu', 'Jing Li', 'Xialin Wang', 'Zhengfeng Chen', 'Sreemanee Raaj Dorajoo', 'Mengling Feng', 'Min-Huei Hsu', 'Jason C Hsu', 'Kee Yuan Ngiam', 'Jillian C Shipherd', 'Elise Gatsby', 'Pierre A Elias', 'Michael V Reyes', 'Elain Y Wan', 'Utpal B Pajvani', 'Hossein Estiri', 'Carsten Goerg', 'Erin Holve', 'Marianne Hamilton-Lopez', 'Nicholas J Leeper', 'Gayle Murray', 'Rashmie Abeysinghe', 'Adam Black', 'Yupeng Li', 'Lixia Yao', 'Joao Paulo Barraca', 'Benoit L Marteau', 'Yuanda Zhu', 'Felipe Giuste', 'Wenqi Shi', 'Ashley Carpenter', 'Coleman Hilton', 'Guohui Xiao', 'Carina Nina Vorisek', 'Moritz Lehne', 'Sophie Anne Ines Klopfenstein', 'Paula Josephine Mayer', 'Alexander Bartschke', 'Thomas Haese', 'Linying Zhang', 'Yixin Wang', 'David M Blei', 'Evan F Joiner', 'Guy M McKhann', 'Alfred I Neugut', 'Akihiko Nishimura', 'Sunho Choi', 'Hyung Joon Joo', 'Yoojoong Kim', 'Song Wang', 'Mingquan Lin', 'Ying Ding', 'George Shih', 'Zhiyong Lu', 'Rory J McCrimmon', 'Alice Y Y Cheng', 'Gagik Galstyan', 'Khier Djaballah', 'Xuan Li', 'Mathieu Coudert', 'Johannes A Kroes', 'Aruna T Bansal', 'Emmanuelle Berret', 'Nils Christian', 'Andreas Kremer', 'Chris Marshall', 'Scott Wagers', 'Ratko Djukanovic', 'Celeste Porsbjerg', 'Dominique Hamerlijnck', 'Olivia Fulton', 'Anneke Ten Brinke', 'Elisabeth H Bel', 'Jeong Hoon Lee', 'Grace Juyun Kim', 'Jong-Yeup Kim', 'Inseok Ko', 'Seon Choe', 'Markus Wolfien', 'Mathilde Fruchart', 'Anais Payen', 'Thibaut Balcaen', 'William Gacquer', 'Guillaume Bouzille', 'Marc Cuggia', 'Woo Kyung Bae', 'Jihoon Cho', 'Sofia Bazakou', 'Anne Van Winzum', 'Alessia Peviani', 'Lara J Kanbar', 'Judith W Dexheimer', 'Janet Zahner', 'Robert Chatburn', 'Amanda Messinger', 'Christopher D Baker', 'Christine L Schuler', 'Dan Benscoter', 'Raouf Amin', 'Tae Kyu Chung', 'Yoomin Jeon', 'YeSol Hong', 'Suyeon Hong', 'Jun Sik Moon', 'Elzo Pereira Pinto Junior', 'Priscilla Normando', 'Renzo Flores-Ortiz', 'Muhammad Usman Afzal', 'Muhammad Asaad Jamil', 'Vinicius de Araujo Oliveira', 'Valentina Martufi', 'Fernanda de Sousa', 'Amir Bashir', 'Maria Yury Ichihara', 'Mauricio L Barreto', 'Haroon Hafeez', 'Tianchu Lyu', 'Chen Liang', 'Jihong Liu', 'Berry Campbell', 'Peiyin Hung', 'Yi-Wen Shih', 'Nadia Ghumman', 'Caroline Bonisch', 'Dorothea Kesztyus', 'Philipp Wegner', 'Geena Mariya Jose', 'Vanessa Lage-Rupprecht', 'Sepehr Golriz Khatami', 'Bide Zhang', 'Stephan Springstubbe', 'Marc Jacobs', 'Thomas Linden', 'Cindy Ku', 'Bruce Schultz', 'Martin Hofmann-Apitius', 'Simona Carini', 'Spencer Phillips Hey', 'Ida Sim', 'Jeong Won Shin', 'Xiao Wang', 'Wenwang Rao', 'Xueyan Chen', 'Xinqiao Zhang', 'Zeng Wang', 'Xianglin Ma', 'Emily Jefferson', 'Christian Cole', 'Shahzad Mumtaz', 'Samuel Cox', 'Thomas Charles Giles', 'Sam Adejumo', 'Esmond Urwin', 'Daniel Lea', 'Calum Macdonald', 'Joseph Best', 'Erum Masood', 'Gordon Milligan', 'Jenny Johnston', 'Ipek Birced', 'Christopher Hall', 'Aaron S Jackson', 'Clare Collins', 'Sam Rising', 'Charlotte Dodsley', 'Jill Hampton', 'Andrew Hadfield', 'Roberto Santos', 'Simon Tarr', 'Vasiliki Panagi', 'Joseph Lavagna', 'Tracy Jackson', 'Magdalena Martinez-Queipo', 'Helen Ward', 'Julie von Ziegenweidt', 'Frances Burns', 'Joanne Martin', 'Neil Sebire', 'Carole Morris', 'Rob Baxter', 'Anni Ahonen-Bishopp', 'Paul Smith', 'Amelia Shoemark', 'Ana M Valdes', 'Benjamin Ollivere', 'Charlotte Manisty', 'David Eyre', 'Stephanie Gallant', 'George Joy', 'Andrew McAuley', 'David Connell', 'Kate Northstone', 'Katie Jeffery', 'Emanuele Di Angelantonio', 'Amy McMahon', 'Mat Walker', 'Malcolm Gracie Semple', 'Jessica Mai Sims', 'Emma Lawrence', 'Bethan Davies', 'John Kenneth Baillie', 'Ming Tang', 'Gary Leeming', 'Linda Power', 'Thomas Breeze', 'Duncan Murray', 'Chris Orton', 'Iain Pierce', 'Ian Hall', 'Shamez Ladhani', 'Natalie Gillson', 'Matthew Whitaker', 'Laura Shallcross', 'David Seymour', 'Susheel Varma', 'Gerry Reilly', 'Andrew Morris', 'Susan Hopkins', 'Hyung Seok Lee', 'N Hughes', 'K van Bochove', 'T Duarte-Salles', 'C Steinbeisser', 'D Vizcaya', 'D Prieto-Alhambra', 'Veronika Pav', 'Andrew Burns', 'Courtney Colahan', 'Brian Robison', 'Jacob Kean', 'Ki-Yeol Park', 'Min-Ho Kim', 'Seong-Ho Choi', 'Byungjin Choi', 'Bryan Laraway', 'Corneliu Antonescu', 'Michael Gargano', 'Kenneth J Wilkins', 'Nariman Ammar', 'Blessy Antony', 'T M Murali', 'J Harry Caufield', 'Jineta Banerjee', 'Anthony E Solomonides', 'Hannah Davis', 'David Sahner', 'Xiang Cheng', 'Meiling Cheng', 'Liyi Yu', 'Kangah Park', 'Minsu Cho', 'Minseok Song', 'Eric Brandt', 'Tom Forsyth', 'Shumin Zhang', 'Jiajing Chen', 'Peter A Noseworthy', 'Amit A Doshi', 'Kimberly Collison-Farr', 'Dure Kim', 'Joseph S Ross', 'Paul M Coplan', 'James T Brash', 'Cigdem Turkmen', 'Stefan Driessen', 'Giustino Varrassi', 'Saskia Fuhrmann', 'Andreas Fischer', 'Hao Luo', 'Wallis C Y Lau', 'Yi Chai', 'Robert Howard', 'Kathy Y Liu', 'Xiaoyu Lin', 'Can Yin', 'Jae-Won Jang', 'Celine S L Chui', 'David Moreno-Martos']",783,2102
